AAAACTAAGGCACGCCATA -> AAACTAAGGCACGCCATAT
AAAAGAGTCCTCCAACCGA -> AAAGAGTCCTCCAACCGAG
AAAAGGAGGCCATGCACGG -> AAAGGAGGCCATGCACGGC
AAAAGGCACTCTATGGGAA -> AAAGGCACTCTATGGGAAT
AAAATCGATAGCCGGTCCG -> AAATCGATAGCCGGTCCGA
AAAATCTCGGAAAAGGAGG -> AAATCTCGGAAAAGGAGGC
AAAATCTTGCGATTATCTG -> AAATCTTGCGATTATCTGC
AAACACCCGATTATTGTGG -> AACACCCGATTATTGTGGG
AAACACTCCGGCCGTCTAG -> AACACTCCGGCCGTCTAGT
AAACCACACTATAGGTCGC -> AACCACACTATAGGTCGCA
AAACCCAACCCCGCATGTA -> AACCCAACCCCGCATGTAG
AAACCGTCGAAGTTACCTG -> AACCGTCGAAGTTACCTGC
AAACGAACCCTGAACTATA -> AACGAACCCTGAACTATAA
AAACGCGGTTGCGGAGGAT -> AACGCGGTTGCGGAGGATG
AAACGGTGCCGTCGGGTTT -> AACGGTGCCGTCGGGTTTG
AAACGGTGCTCATTTCTGT -> AACGGTGCTCATTTCTGTA
AAACTAAGGCACGCCATAT -> AACTAAGGCACGCCATATA
AAACTAGGGCAACTTTGGG -> AACTAGGGCAACTTTGGGA
AAAGACGGGCTATCGTATT -> AAGACGGGCTATCGTATTT
AAAGAGGTGGAATGGGTGG -> AAGAGGTGGAATGGGTGGT
AAAGAGTCCTCCAACCGAG -> AAGAGTCCTCCAACCGAGA
AAAGCAGACAGCGTGTGTA -> AAGCAGACAGCGTGTGTAC
AAAGCCCGTTAAATCTTAG -> AAGCCCGTTAAATCTTAGA
AAAGCCGAGCTCGTATTGT -> AAGCCGAGCTCGTATTGTC
AAAGCGTAACCGCCGTTCC -> AAGCGTAACCGCCGTTCCC
AAAGGAAGAGGTCGGGGCA -> AAGGAAGAGGTCGGGGCAC
AAAGGAGGCCATGCACGGC -> AAGGAGGCCATGCACGGCC
AAAGGCACTCTATGGGAAT -> AAGGCACTCTATGGGAATC
AAAGTGGGTACAATCCGCA -> AAGTGGGTACAATCCGCAG
AAATAAAATCGATAGCCGG -> AATAAAATCGATAGCCGGT
AAATAAATAATACTGGTTC -> AATAAATAATACTGGTTCC
AAATAATACTGGTTCCTCC -> AATAATACTGGTTCCTCCG
AAATACCAAACCGTCGAAG -> AATACCAAACCGTCGAAGT
AAATAGTCCCTGTTTGCAC -> AATAGTCCCTGTTTGCACT
AAATCACGGGTCCCAGAAG -> AATCACGGGTCCCAGAAGT
AAATCATAAGGATGCGATC -> AATCATAAGGATGCGATCG
AAATCCAACAACCGTGCGC -> AATCCAACAACCGTGCGCA
AAATCCCCCTTTAACGCGC -> AATCCCCCTTTAACGCGCA
AAATCGATAGCCGGTCCGA -> AATCGATAGCCGGTCCGAC
AAATCTCGGAAAAGGAGGC -> AATCTCGGAAAAGGAGGCC
AAATCTTACACGGACCATA -> AATCTTACACGGACCATAC
AAATCTTAGAGTTACGGGT -> AATCTTAGAGTTACGGGTT
AAATCTTGCGATTATCTGC -> AATCTTGCGATTATCTGCA
AAATGACGGTAGGTAGAAG -> AATGACGGTAGGTAGAAGT
AAATGTAATTAAGTCCCTG -> AATGTAATTAAGTCCCTGC
AAATTACCTCGGAAACCCA -> AATTACCTCGGAAACCCAA
AAATTATGTGCGAGCTTGT -> AATTATGTGCGAGCTTGTC
AAATTGCGACACCGGCTGA -> AATTGCGACACCGGCTGAC
AAATTTGGGATGGGAGAAG -> AATTTGGGATGGGAGAAGT
AACAAAGGAAGAGGTCGGG -> ACAAAGGAAGAGGTCGGGG
AACAAATCATAAGGATGCG -> ACAAATCATAAGGATGCGA
AACAACCGTGCGCATCGTA -> ACAACCGTGCGCATCGTAG
AACACCCGATTATTGTGGG -> ACACCCGATTATTGTGGGT
AACACTATGCCTCGGAAAA -> ACACTATGCCTCGGAAAAT
AACACTCCGGCCGTCTAGT -> ACACTCCGGCCGTCTAGTA
AACCACACTATAGGTCGCA -> ACCACACTATAGGTCGCAG
AACCCAACCCCGCATGTAG -> ACCCAACCCCGCATGTAGG
AACCCCGCATGTAGGAAAA -> ACCCCGCATGTAGGAAAAT
AACCCCGGTGACATTAAAG -> ACCCCGGTGACATTAAAGC
AACCCGCGGGAGGCCCATG -> ACCCGCGGGAGGCCCATGC
AACCCTGAACTATAATGCA -> ACCCTGAACTATAATGCAC
AACCGAGATGGTACTTCAG -> ACCGAGATGGTACTTCAGA
AACCGCCGTTCCCTAATCA -> ACCGCCGTTCCCTAATCAA
AACCGGCACTCCTCTACCT -> ACCGGCACTCCTCTACCTT
AACCGTCGAAGTTACCTGC -> ACCGTCGAAGTTACCTGCG
AACCGTGCGCATCGTAGGC -> ACCGTGCGCATCGTAGGCT
AACGAACCCTGAACTATAA -> ACGAACCCTGAACTATAAT
AACGCGCATGCCGAAGAAG -> ACGCGCATGCCGAAGAAGG
AACGCGGTTGCGGAGGATG -> ACGCGGTTGCGGAGGATGC
AACGGGGAGGGCCAACCCC -> ACGGGGAGGGCCAACCCCG
AACGGGGGTCTGGTTGTTG -> ACGGGGGTCTGGTTGTTGG
AACGGTGCCGTCGGGTTTG -> ACGGTGCCGTCGGGTTTGA
AACGGTGCTCATTTCTGTA -> ACGGTGCTCATTTCTGTAT
AACGTGTGCTAAACGAACC -> ACGTGTGCTAAACGAACCC
AACTAAACGGTGCTCATTT -> ACTAAACGGTGCTCATTTC
AACTAAGGCACGCCATATA -> ACTAAGGCACGCCATATAC
AACTAGGGCAACTTTGGGA -> ACTAGGGCAACTTTGGGAG
AACTATAATGCACTACAAG -> ACTATAATGCACTACAAGT
AACTATCAAAGAGGTGGAA -> ACTATCAAAGAGGTGGAAT
AACTGCCGTCCACATCGCC -> ACTGCCGTCCACATCGCCG
AACTGCTCTTTTCTCAAGC -> ACTGCTCTTTTCTCAAGCT
AACTGTAATGAAAAGGCAC -> ACTGTAATGAAAAGGCACT
AACTTTGGGAGATTCGCGG -> ACTTTGGGAGATTCGCGGT
AAGAACTATCAAAGAGGTG -> AGAACTATCAAAGAGGTGG
AAGAAGGTGTGTCATGTCC -> AGAAGGTGTGTCATGTCCC
AAGACGGGCTATCGTATTT -> AGACGGGCTATCGTATTTT
AAGACTGCAATTTAGGGGA -> AGACTGCAATTTAGGGGAT
AAGAGGTCGGGGCACGCGA -> AGAGGTCGGGGCACGCGAA
AAGAGGTGGAATGGGTGGT -> AGAGGTGGAATGGGTGGTA
AAGAGTCCTCCAACCGAGA -> AGAGTCCTCCAACCGAGAT
AAGATAATATGAGGTATGA -> AGATAATATGAGGTATGAA
AAGCACGAATCTAGAGAGA -> AGCACGAATCTAGAGAGAG
AAGCAGACAGCGTGTGTAC -> AGCAGACAGCGTGTGTACA
AAGCCCGTTAAATCTTAGA -> AGCCCGTTAAATCTTAGAG
AAGCCGAGCTCGTATTGTC -> AGCCGAGCTCGTATTGTCG
AAGCGAATTGCTGACCTAT -> AGCGAATTGCTGACCTATT
AAGCGGTACAGACGTTTTT -> AGCGGTACAGACGTTTTTG
AAGCGTAACCGCCGTTCCC -> AGCGTAACCGCCGTTCCCT
AAGCTAGGCGGTCAAGGCG -> AGCTAGGCGGTCAAGGCGC
AAGCTTAATATACTTTTAT -> AGCTTAATATACTTTTATC
AAGCTTTGAAAGCCCGTTA -> AGCTTTGAAAGCCCGTTAA
AAGGAAGAGGTCGGGGCAC -> AGGAAGAGGTCGGGGCACG
AAGGAGGCCATGCACGGCC -> AGGAGGCCATGCACGGCCA
AAGGATATTCATTCGGCTT -> AGGATATTCATTCGGCTTC
AAGGATGCGATCGCCGTAT -> AGGATGCGATCGCCGTATT
AAGGCACGCCATATACTAA -> AGGCACGCCATATACTAAC
AAGGCACTCTATGGGAATC -> AGGCACTCTATGGGAATCT
AAGGCGAAGCGAATTGCTG -> AGGCGAAGCGAATTGCTGA
AAGGCGCTTGTCCTATGCA -> AGGCGCTTGTCCTATGCAT
AAGGGTCCAGACCCATGCC -> AGGGTCCAGACCCATGCCC
AAGGGTTGAACAAAGGAAG -> AGGGTTGAACAAAGGAAGA
AAGGTGTGTCATGTCCCAC -> AGGTGTGTCATGTCCCACC
AAGTCACGGCTAATAAATT -> AGTCACGGCTAATAAATTG
AAGTCCCTGCGGTTATAAA -> AGTCCCTGCGGTTATAAAC
AAGTCTGTAAATAGTCCCT -> AGTCTGTAAATAGTCCCTG
AAGTGGGGACGGAGAATGA -> AGTGGGGACGGAGAATGAA
AAGTGGGTACAATCCGCAG -> AGTGGGTACAATCCGCAGA
AAGTTACCTGCGCGGTCTA -> AGTTACCTGCGCGGTCTAT
AAGTTACCTGCGCGGTCTC -> AGTTACCTGCGCGGTCTCT
AAGTTACCTGCGCGGTCTT -> AGTTACCTGCGCGGTCTTC,AGTTACCTGCGCGGTCTTC
AAGTTGAGACGCCTCAAAT -> AGTTGAGACGCCTCAAATC
AATAAAATCGATAGCCGGT -> ATAAAATCGATAGCCGGTC
AATAAATAATACTGGTTCC -> ATAAATAATACTGGTTCCT
AATAAATTGCGACACCGGC -> ATAAATTGCGACACCGGCT
AATAATACTGGTTCCTCCG -> ATAATACTGGTTCCTCCGA
AATACCAAACCGTCGAAGT -> ATACCAAACCGTCGAAGTT
AATACTGGTTCCTCCGAAA -> ATACTGGTTCCTCCGAAAC
AATACTTGACACTTCATGC -> ATACTTGACACTTCATGCT
AATAGATGATGGTGACACC -> ATAGATGATGGTGACACCG
AATAGCTAACCGGCACTCC -> ATAGCTAACCGGCACTCCT
AATAGCTACCAACGGGGGT -> ATAGCTACCAACGGGGGTC
AATAGTCCCTGTTTGCACT -> ATAGTCCCTGTTTGCACTG
AATATAAGTCTGTAAATAG -> ATATAAGTCTGTAAATAGT
AATATACTTTTATCTGCGC -> ATATACTTTTATCTGCGCG
AATATGAGGTATGAAGGGT -> ATATGAGGTATGAAGGGTT
AATATGCCGTGGCGGATGG -> ATATGCCGTGGCGGATGGA
AATATGGGGGGGGTCAAAT -> ATATGGGGGGGGTCAAATA
AATCAAGATAATATGAGGT -> ATCAAGATAATATGAGGTA
AATCACGGGTCCCAGAAGT -> ATCACGGGTCCCAGAAGTT
AATCATAAGGATGCGATCG -> ATCATAAGGATGCGATCGC
AATCCAACAACCGTGCGCA -> ATCCAACAACCGTGCGCAT
AATCCATCAATATGCCGTG -> ATCCATCAATATGCCGTGG
AATCCCCCTTTAACGCGCA -> ATCCCCCTTTAACGCGCAT
AATCCGCAGAAAAGAGTCC -> ATCCGCAGAAAAGAGTCCT
AATCCTACCATACCGCCAA -> ATCCTACCATACCGCCAAA
AATCGATAGCCGGTCCGAC -> ATCGATAGCCGGTCCGACA
AATCTAAATTACCTCGGAA -> ATCTAAATTACCTCGGAAA
AATCTAGAGAGAGATATCG -> ATCTAGAGAGAGATATCGC
AATCTCGAGAAGCGGTACA -> ATCTCGAGAAGCGGTACAG
AATCTCGGAAAAGGAGGCC -> ATCTCGGAAAAGGAGGCCA
AATCTTACACGGACCATAC -> ATCTTACACGGACCATACG
AATCTTAGAGTTACGGGTT -> ATCTTAGAGTTACGGGTTC
AATCTTGCGATTATCTGCA -> ATCTTGCGATTATCTGCAA
AATGAAAAGGCACTCTATG -> ATGAAAAGGCACTCTATGG
AATGAATACTTGACACTTC -> ATGAATACTTGACACTTCA
AATGACGGTAGGTAGAAGT -> ATGACGGTAGGTAGAAGTT
AATGAGGTCGATGTGTCCC -> ATGAGGTCGATGTGTCCCT
AATGAGTGCATCGTAATCT -> ATGAGTGCATCGTAATCTA
AATGCACTACAAGTCACGG -> ATGCACTACAAGTCACGGC
AATGGGTGGTAATTGGCTA -> ATGGGTGGTAATTGGCTAT
AATGTAATTAAGTCCCTGC -> ATGTAATTAAGTCCCTGCG
AATTAAGTCCCTGCGGTTA -> ATTAAGTCCCTGCGGTTAT
AATTACCTCGGAAACCCAA -> ATTACCTCGGAAACCCAAC
AATTATGTGCGAGCTTGTC -> ATTATGTGCGAGCTTGTCG
AATTCGCAAGCTTAATATA -> ATTCGCAAGCTTAATATAC
AATTGCGACACCGGCTGAC -> ATTGCGACACCGGCTGACT
AATTGCTGACCTATTAGAA -> ATTGCTGACCTATTAGAAA
AATTGCTGGCGTTAAACGG -> ATTGCTGGCGTTAAACGGT
AATTGGAAGGCGAAGCGAA -> ATTGGAAGGCGAAGCGAAT
AATTGGCTATTCTGACCCC -> ATTGGCTATTCTGACCCCC
AATTTAGGGGATCTTTCGG -> ATTTAGGGGATCTTTCGGA
AATTTGCTGGATTGAAGAA -> ATTTGCTGGATTGAAGAAC
AATTTGGGATGGGAGAAGT -> ATTTGGGATGGGAGAAGTT
ACAAAGGAAGAGGTCGGGG -> CAAAGGAAGAGGTCGGGGC
ACAAATCATAAGGATGCGA -> CAAATCATAAGGATGCGAT
ACAAATCCCCCTTTAACGC -> CAAATCCCCCTTTAACGCG
ACAACCGTGCGCATCGTAG -> CAACCGTGCGCATCGTAGG
ACAACGGGGAGGGCCAACC -> CAACGGGGAGGGCCAACCC
ACAAGCACGAATCTAGAGA -> CAAGCACGAATCTAGAGAG
ACAAGTCACGGCTAATAAA -> CAAGTCACGGCTAATAAAT
ACAATCCGCAGAAAAGAGT -> CAATCCGCAGAAAAGAGTC
ACACATCGTACTAAAGCGT -> CACATCGTACTAAAGCGTA
ACACCCGATTATTGTGGGT -> CACCCGATTATTGTGGGTT
ACACCGGCTGACTATCGAA -> CACCGGCTGACTATCGAAT
ACACCGGTTGTCGGCCGAG -> CACCGGTTGTCGGCCGAGT
ACACCTGCAGGTGGGCACG -> CACCTGCAGGTGGGCACGA
ACACGGACCATACGGTGAT -> CACGGACCATACGGTGATA
ACACGTCGACCTTCTCTTT -> CACGTCGACCTTCTCTTTG
ACACTACGCACTAAGACTG -> CACTACGCACTAAGACTGC
ACACTATAGGTCGCAGCAT -> CACTATAGGTCGCAGCATT
ACACTATGCCTCGGAAAAT -> CACTATGCCTCGGAAAATC
ACACTCCGGCCGTCTAGTA -> CACTCCGGCCGTCTAGTAG
ACACTTCATGCTGTGCTAA -> CACTTCATGCTGTGCTAAG
ACAGACGTTTTTGTCGGCC -> CAGACGTTTTTGTCGGCCG
ACAGCGTGTGTACACTACG -> CAGCGTGTGTACACTACGC
ACAGCTATGCGGGAAGCTA -> CAGCTATGCGGGAAGCTAG
ACAGGTGGCGACGTGTTCT -> CAGGTGGCGACGTGTTCTT
ACATATGAAATTATGTGCG -> CATATGAAATTATGTGCGA
ACATATTTATAATTGGAAG -> CATATTTATAATTGGAAGG
ACATCCTAGCACCTCAATA -> CATCCTAGCACCTCAATAT
ACATCGCCGAAAGTGGGTA -> CATCGCCGAAAGTGGGTAC
ACATCGTACTAAAGCGTAA -> CATCGTACTAAAGCGTAAC
ACATTAAAGCCGAGCTCGT -> CATTAAAGCCGAGCTCGTA
ACCAAACCGTCGAAGTTAC -> CCAAACCGTCGAAGTTACC
ACCAACGGGGGTCTGGTTG -> CCAACGGGGGTCTGGTTGT
ACCACACTATAGGTCGCAG -> CCACACTATAGGTCGCAGC
ACCATACCGCCAAAACTAA -> CCATACCGCCAAAACTAAG
ACCATACGGTGATACCCTA -> CCATACGGTGATACCCTAC
ACCCAAATCCAACAACCGT -> CCCAAATCCAACAACCGTG
ACCCAACCCCGCATGTAGG -> CCCAACCCCGCATGTAGGA
ACCCACGGGCGGGGATCGA -> CCCACGGGCGGGGATCGAC
ACCCATGCCCTGCACTCTT -> CCCATGCCCTGCACTCTTC
ACCCCCAACTGCCGTCCAC -> CCCCCAACTGCCGTCCACA
ACCCCGCATGTAGGAAAAT -> CCCCGCATGTAGGAAAATC
ACCCCGGTGACATTAAAGC -> CCCCGGTGACATTAAAGCC
ACCCGATTATTGTGGGTTT -> CCCGATTATTGTGGGTTTA
ACCCGCGGGAGGCCCATGC -> CCCGCGGGAGGCCCATGCT
ACCCGTGTACTTTAGCGGC -> CCCGTGTACTTTAGCGGCG
ACCCTACACCTGCAGGTGG -> CCCTACACCTGCAGGTGGG
ACCCTGAACTATAATGCAC -> CCCTGAACTATAATGCACT
ACCGAGATGGTACTTCAGA -> CCGAGATGGTACTTCAGAA
ACCGATGACTGAGAGAATG -> CCGATGACTGAGAGAATGA
ACCGCCAAAACTAAGGCAC -> CCGCCAAAACTAAGGCACG
ACCGCCGTTCCCTAATCAA -> CCGCCGTTCCCTAATCAAG
ACCGGCACTCCTCTACCTT -> CCGGCACTCCTCTACCTTG
ACCGGCTGACTATCGAATT -> CCGGCTGACTATCGAATTG
ACCGGGATTAATCCTACCA -> CCGGGATTAATCCTACCAT
ACCGGTTGTCGGCCGAGTG -> CCGGTTGTCGGCCGAGTGA
ACCGTCGAAGTTACCTGCG -> CCGTCGAAGTTACCTGCGC
ACCGTGCGCATCGTAGGCT -> CCGTGCGCATCGTAGGCTC
ACCTATTAGAAAGCAGACA -> CCTATTAGAAAGCAGACAG
ACCTCAATATAAGTCTGTA -> CCTCAATATAAGTCTGTAA
ACCTCGGAAACCCAACCCC -> CCTCGGAAACCCAACCCCG
ACCTCGGAGATCGGTTTTG -> CCTCGGAGATCGGTTTTGC
ACCTGCAGGTGGGCACGAG -> CCTGCAGGTGGGCACGAGC
ACCTGCGCGGTCTATGTCC -> CCTGCGCGGTCTATGTCCG
ACCTGCGCGGTCTCTCGCG -> CCTGCGCGGTCTCTCGCGG
ACCTGCGCGGTCTTCTGGG -> CCTGCGCGGTCTTCTGGGA
ACCTGCGCGGTCTTCTTTA -> CCTGCGCGGTCTTCTTTAC
ACCTTCTCTTTGAACCCGC -> CCTTCTCTTTGAACCCGCG
ACCTTGACAACGGGGAGGG -> CCTTGACAACGGGGAGGGC
ACGAACCCTGAACTATAAT -> CGAACCCTGAACTATAATG
ACGAATCTAGAGAGAGATA -> CGAATCTAGAGAGAGATAT
ACGAGCGTCATTAAAGACG -> CGAGCGTCATTAAAGACGG
ACGATGTAGCAACGTGTGC -> CGATGTAGCAACGTGTGCT
ACGCACTAAGACTGCAATT -> CGCACTAAGACTGCAATTT
ACGCCATATACTAACAAAT -> CGCCATATACTAACAAATC
ACGCCTCAAATCTTACACG -> CGCCTCAAATCTTACACGG
ACGCGAATTCGCAAGCTTA -> CGCGAATTCGCAAGCTTAA
ACGCGCATGCCGAAGAAGG -> CGCGCATGCCGAAGAAGGT
ACGCGGTTGCGGAGGATGC -> CGCGGTTGCGGAGGATGCG
ACGGACAGGTGGCGACGTG -> CGGACAGGTGGCGACGTGT
ACGGACCATACGGTGATAC -> CGGACCATACGGTGATACC
ACGGAGAATGAATACTTGA -> CGGAGAATGAATACTTGAC
ACGGCCACTTGGCTGTATT -> CGGCCACTTGGCTGTATTA
ACGGCTAATAAATTGCGAC -> CGGCTAATAAATTGCGACA
ACGGGCGGGGATCGACTTA -> CGGGCGGGGATCGACTTAG
ACGGGCTATCGTATTTTTA -> CGGGCTATCGTATTTTTAC
ACGGGGAGGGCCAACCCCG -> CGGGGAGGGCCAACCCCGG
ACGGGGGTCTGGTTGTTGG -> CGGGGGTCTGGTTGTTGGA
ACGGGTCCCAGAAGTTACC -> CGGGTCCCAGAAGTTACCT
ACGGGTTCCTAGACCCACG -> CGGGTTCCTAGACCCACGG
ACGGTAGGTAGAAGTTACC -> CGGTAGGTAGAAGTTACCT
ACGGTGATACCCTACACCT -> CGGTGATACCCTACACCTG
ACGGTGCCGTCGGGTTTGA -> CGGTGCCGTCGGGTTTGAA
ACGGTGCTCATTTCTGTAT -> CGGTGCTCATTTCTGTATG
ACGTACGTGATCGTTCCTG -> CGTACGTGATCGTTCCTGC
ACGTCGACCTTCTCTTTGA -> CGTCGACCTTCTCTTTGAA
ACGTGATCGTTCCTGCCGT -> CGTGATCGTTCCTGCCGTA
ACGTGTGCTAAACGAACCC -> CGTGTGCTAAACGAACCCT
ACGTGTTCTTGCGCGAGCA -> CGTGTTCTTGCGCGAGCAC
ACGTTTTTGTCGGCCGAGT -> CGTTTTTGTCGGCCGAGTG
ACTAAACGGTGCTCATTTC -> CTAAACGGTGCTCATTTCT
ACTAAAGCGTAACCGCCGT -> CTAAAGCGTAACCGCCGTT
ACTAACAAATCATAAGGAT -> CTAACAAATCATAAGGATG
ACTAAGACTGCAATTTAGG -> CTAAGACTGCAATTTAGGG
ACTAAGGCACGCCATATAC -> CTAAGGCACGCCATATACT
ACTAATAGCTACCAACGGG -> CTAATAGCTACCAACGGGG
ACTACAAGTCACGGCTAAT -> CTACAAGTCACGGCTAATA
ACTACGCACTAAGACTGCA -> CTACGCACTAAGACTGCAA
ACTAGGGCAACTTTGGGAG -> CTAGGGCAACTTTGGGAGA
ACTATAATGCACTACAAGT -> CTATAATGCACTACAAGTC
ACTATAGGTCGCAGCATTT -> CTATAGGTCGCAGCATTTA
ACTATCAAAGAGGTGGAAT -> CTATCAAAGAGGTGGAATG
ACTATCGAATTGCTGGCGT -> CTATCGAATTGCTGGCGTT
ACTATGCCTCGGAAAATCT -> CTATGCCTCGGAAAATCTT
ACTCCGGCCGTCTAGTAGT -> CTCCGGCCGTCTAGTAGTG
ACTCCTCTACCTTGACAAC -> CTCCTCTACCTTGACAACG
ACTCTATGGGAATCTCGAG -> CTCTATGGGAATCTCGAGA
ACTCTTCTACCCGGTCTAG -> CTCTTCTACCCGGTCTAGT
ACTGAGAGAATGAGTGCAT -> CTGAGAGAATGAGTGCATC
ACTGAGTACAAGCACGAAT -> CTGAGTACAAGCACGAATC
ACTGCAATTTAGGGGATCT -> CTGCAATTTAGGGGATCTT
ACTGCCGTCCACATCGCCG -> CTGCCGTCCACATCGCCGA
ACTGCTCTTTTCTCAAGCT -> CTGCTCTTTTCTCAAGCTT
ACTGGTCTTCATACTAATA -> CTGGTCTTCATACTAATAG
ACTGGTTCCTCCGAAACCA -> CTGGTTCCTCCGAAACCAC
ACTGTAATGAAAAGGCACT -> CTGTAATGAAAAGGCACTC
ACTTAGTCGGAATATGGGG -> CTTAGTCGGAATATGGGGG
ACTTCAGAATAGATGATGG -> CTTCAGAATAGATGATGGT
ACTTCATGCTGTGCTAAGT -> CTTCATGCTGTGCTAAGTT
ACTTGACACTTCATGCTGT -> CTTGACACTTCATGCTGTG
ACTTGGCTGTATTAAACAC -> CTTGGCTGTATTAAACACC
ACTTTAGCGGCGCCTATTA -> CTTTAGCGGCGCCTATTAA
ACTTTGGGAGATTCGCGGT -> CTTTGGGAGATTCGCGGTG
ACTTTTATCTGCGCGTGCC -> CTTTTATCTGCGCGTGCCA
AGAAAAGAGTCCTCCAACC -> GAAAAGAGTCCTCCAACCG
AGAAAGCAGACAGCGTGTG -> GAAAGCAGACAGCGTGTGT
AGAAATGTAATTAAGTCCC -> GAAATGTAATTAAGTCCCT
AGAACTATCAAAGAGGTGG -> GAACTATCAAAGAGGTGGA
AGAAGCGGTACAGACGTTT -> GAAGCGGTACAGACGTTTT
AGAAGGTGTGTCATGTCCC -> GAAGGTGTGTCATGTCCCA
AGAAGTTACCTGCGCGGTC -> GAAGTTACCTGCGCGGTCT,GAAGTTACCTGCGCGGTCT,GAAGTTACCTGCGCGGTCT
AGAATAGATGATGGTGACA -> GAATAGATGATGGTGACAC
AGAATGAATACTTGACACT -> GAATGAATACTTGACACTT
AGAATGAGTGCATCGTAAT -> GAATGAGTGCATCGTAATC
AGACAGCGTGTGTACACTA -> GACAGCGTGTGTACACTAC
AGACCCACGGGCGGGGATC -> GACCCACGGGCGGGGATCG
AGACCCATGCCCTGCACTC -> GACCCATGCCCTGCACTCT
AGACCCGTGTACTTTAGCG -> GACCCGTGTACTTTAGCGG
AGACCGATGACTGAGAGAA -> GACCGATGACTGAGAGAAT
AGACGCCTCAAATCTTACA -> GACGCCTCAAATCTTACAC
AGACGGGCTATCGTATTTT -> GACGGGCTATCGTATTTTT
AGACGTACGTGATCGTTCC -> GACGTACGTGATCGTTCCT
AGACGTTTTTGTCGGCCGA -> GACGTTTTTGTCGGCCGAG
AGACTGCAATTTAGGGGAT -> GACTGCAATTTAGGGGATC
AGAGAATGAGTGCATCGTA -> GAGAATGAGTGCATCGTAA
AGAGACCCGTGTACTTTAG -> GAGACCCGTGTACTTTAGC
AGAGACCGATGACTGAGAG -> GAGACCGATGACTGAGAGA
AGAGAGAGATATCGCGTGG -> GAGAGAGATATCGCGTGGG
AGAGAGAGTCCAAACTAGG -> GAGAGAGTCCAAACTAGGG
AGAGAGATATCGCGTGGGG -> GAGAGATATCGCGTGGGGA
AGAGAGTCCAAACTAGGGC -> GAGAGTCCAAACTAGGGCA
AGAGATATCGCGTGGGGAG -> GAGATATCGCGTGGGGAGT
AGAGGTCGGGGCACGCGAA -> GAGGTCGGGGCACGCGAAT
AGAGGTGGAATGGGTGGTA -> GAGGTGGAATGGGTGGTAA
AGAGTCCAAACTAGGGCAA -> GAGTCCAAACTAGGGCAAC
AGAGTCCTCCAACCGAGAT -> GAGTCCTCCAACCGAGATG
AGAGTTACGGGTTCCTAGA -> GAGTTACGGGTTCCTAGAC
AGATAATATGAGGTATGAA -> GATAATATGAGGTATGAAG
AGATATCGCGTGGGGAGTA -> GATATCGCGTGGGGAGTAG
AGATCGGTTTTGCGGCCAA -> GATCGGTTTTGCGGCCAAC
AGATGATGGTGACACCGGT -> GATGATGGTGACACCGGTT
AGATGGGGCTAGAGAGAGT -> GATGGGGCTAGAGAGAGTC
AGATGGTACTTCAGAATAG -> GATGGTACTTCAGAATAGA
AGATTCGCGGTGCTGTAAG -> GATTCGCGGTGCTGTAAGG
AGCAACGTGTGCTAAACGA -> GCAACGTGTGCTAAACGAA
AGCACCTCAATATAAGTCT -> GCACCTCAATATAAGTCTG
AGCACCTCGGAGATCGGTT -> GCACCTCGGAGATCGGTTT
AGCACGAATCTAGAGAGAG -> GCACGAATCTAGAGAGAGA
AGCAGACAGCGTGTGTACA -> GCAGACAGCGTGTGTACAC
AGCATGTTGTCAAATAAAT -> GCATGTTGTCAAATAAATA
AGCATTTAATGAGGTCGAT -> GCATTTAATGAGGTCGATG
AGCCCGTTAAATCTTAGAG -> GCCCGTTAAATCTTAGAGT
AGCCGAGCTCGTATTGTCG -> GCCGAGCTCGTATTGTCGG
AGCCGGTCCGACATATGAA -> GCCGGTCCGACATATGAAA
AGCGAATTGCTGACCTATT -> GCGAATTGCTGACCTATTA
AGCGCTTGGAAGTGGGGAC -> GCGCTTGGAAGTGGGGACG
AGCGGCGCCTATTAATCCA -> GCGGCGCCTATTAATCCAT
AGCGGTACAGACGTTTTTG -> GCGGTACAGACGTTTTTGT
AGCGTAACCGCCGTTCCCT -> GCGTAACCGCCGTTCCCTA
AGCGTCATTAAAGACGGGC -> GCGTCATTAAAGACGGGCT
AGCGTGTGTACACTACGCA -> GCGTGTGTACACTACGCAC
AGCTAACCGGCACTCCTCT -> GCTAACCGGCACTCCTCTA
AGCTACCAACGGGGGTCTG -> GCTACCAACGGGGGTCTGG
AGCTAGGCGGTCAAGGCGC -> GCTAGGCGGTCAAGGCGCT
AGCTATGCGGGAAGCTAGG -> GCTATGCGGGAAGCTAGGC
AGCTCGTATTGTCGGCCGA -> GCTCGTATTGTCGGCCGAG
AGCTTAATATACTTTTATC -> GCTTAATATACTTTTATCT
AGCTTGTCGGCCGAGTGAA -> GCTTGTCGGCCGAGTGAAA
AGCTTTGAAAGCCCGTTAA -> GCTTTGAAAGCCCGTTAAA
AGGAAAATCTCGGAAAAGG -> GGAAAATCTCGGAAAAGGA
AGGAAGAGGTCGGGGCACG -> GGAAGAGGTCGGGGCACGC
AGGAGGCCATGCACGGCCA -> GGAGGCCATGCACGGCCAC
AGGATATTCATTCGGCTTC -> GGATATTCATTCGGCTTCA
AGGATGCGACTGGTCTTCA -> GGATGCGACTGGTCTTCAT
AGGATGCGATCGCCGTATT -> GGATGCGATCGCCGTATTA
AGGCACGCCATATACTAAC -> GGCACGCCATATACTAACA
AGGCACTCTATGGGAATCT -> GGCACTCTATGGGAATCTC
AGGCCATGCACGGCCACTT -> GGCCATGCACGGCCACTTG
AGGCCCATGCTCTTTATAG -> GGCCCATGCTCTTTATAGA
AGGCGAAGCGAATTGCTGA -> GGCGAAGCGAATTGCTGAC
AGGCGCTTGTCCTATGCAT -> GGCGCTTGTCCTATGCATT
AGGCGGTCAAGGCGCTTGT -> GGCGGTCAAGGCGCTTGTC
AGGCTCACAAATCCCCCTT -> GGCTCACAAATCCCCCTTT
AGGGCAACTTTGGGAGATT -> GGGCAACTTTGGGAGATTC
AGGGCCAACCCCGGTGACA -> GGGCCAACCCCGGTGACAT
AGGGGATCTTTCGGAACTG -> GGGGATCTTTCGGAACTGC
AGGGTCCAGACCCATGCCC -> GGGTCCAGACCCATGCCCT
AGGGTTGAACAAAGGAAGA -> GGGTTGAACAAAGGAAGAG
AGGTAGAAGTTACCTGCGC -> GGTAGAAGTTACCTGCGCG
AGGTATGAAGGGTTGAACA -> GGTATGAAGGGTTGAACAA
AGGTCGATGTGTCCCTTGC -> GGTCGATGTGTCCCTTGCA
AGGTCGCAGCATTTAATGA -> GGTCGCAGCATTTAATGAG
AGGTCGGGGCACGCGAATT -> GGTCGGGGCACGCGAATTC
AGGTGGAATGGGTGGTAAT -> GGTGGAATGGGTGGTAATT
AGGTGGCGACGTGTTCTTG -> GGTGGCGACGTGTTCTTGC
AGGTGGGCACGAGCGTCAT -> GGTGGGCACGAGCGTCATT
AGGTGTGTCATGTCCCACC -> GGTGTGTCATGTCCCACCG
AGTACAAGCACGAATCTAG -> GTACAAGCACGAATCTAGA
AGTAGTGCTCAGCATGTTG -> GTAGTGCTCAGCATGTTGT
AGTAGTGGACATCCTAGCA -> GTAGTGGACATCCTAGCAC
AGTCACGGCTAATAAATTG -> GTCACGGCTAATAAATTGC
AGTCCAAACTAGGGCAACT -> GTCCAAACTAGGGCAACTT
AGTCCCTGCGGTTATAAAC -> GTCCCTGCGGTTATAAACA
AGTCCCTGTTTGCACTGAG -> GTCCCTGTTTGCACTGAGT
AGTCCTCCAACCGAGATGG -> GTCCTCCAACCGAGATGGT
AGTCGGAATATGGGGGGGG -> GTCGGAATATGGGGGGGGT
AGTCGTGAATTTGCTGGAT -> GTCGTGAATTTGCTGGATT
AGTCTGTAAATAGTCCCTG -> GTCTGTAAATAGTCCCTGT
AGTGAAATACCAAACCGTC -> GTGAAATACCAAACCGTCG
AGTGAAATCACGGGTCCCA -> GTGAAATCACGGGTCCCAG
AGTGAAATGACGGTAGGTA -> GTGAAATGACGGTAGGTAG
AGTGAAATTTGGGATGGGA -> GTGAAATTTGGGATGGGAG
AGTGAGACGTACGTGATCG -> GTGAGACGTACGTGATCGT
AGTGCATCGTAATCTAAAT -> GTGCATCGTAATCTAAATT
AGTGCTCAGCATGTTGTCA -> GTGCTCAGCATGTTGTCAA
AGTGGACATCCTAGCACCT -> GTGGACATCCTAGCACCTC
AGTGGGGACGGAGAATGAA -> GTGGGGACGGAGAATGAAT
AGTGGGTACAATCCGCAGA -> GTGGGTACAATCCGCAGAA
AGTTACCTGCGCGGTCTAT -> GTTACCTGCGCGGTCTATG
AGTTACCTGCGCGGTCTCT -> GTTACCTGCGCGGTCTCTC
AGTTACCTGCGCGGTCTTC -> GTTACCTGCGCGGTCTTCT,GTTACCTGCGCGGTCTTCT
AGTTACGGGTTCCTAGACC -> GTTACGGGTTCCTAGACCC
AGTTGAGACGCCTCAAATC -> GTTGAGACGCCTCAAATCT
ATAAAATCGATAGCCGGTC -> TAAAATCGATAGCCGGTCC
ATAAACACTCCGGCCGTCT -> TAAACACTCCGGCCGTCTA
ATAAATAATACTGGTTCCT -> TAAATAATACTGGTTCCTC
ATAAATTGCGACACCGGCT -> TAAATTGCGACACCGGCTG
ATAAGGATGCGATCGCCGT -> TAAGGATGCGATCGCCGTA
ATAAGTCTGTAAATAGTCC -> TAAGTCTGTAAATAGTCCC
ATAATACTGGTTCCTCCGA -> TAATACTGGTTCCTCCGAA
ATAATATGAGGTATGAAGG -> TAATATGAGGTATGAAGGG
ATAATGCACTACAAGTCAC -> TAATGCACTACAAGTCACG
ATAATTGGAAGGCGAAGCG -> TAATTGGAAGGCGAAGCGA
ATACCAAACCGTCGAAGTT -> TACCAAACCGTCGAAGTTA
ATACCCTACACCTGCAGGT -> TACCCTACACCTGCAGGTG
ATACCGCCAAAACTAAGGC -> TACCGCCAAAACTAAGGCA
ATACGGTGATACCCTACAC -> TACGGTGATACCCTACACC
ATACTAACAAATCATAAGG -> TACTAACAAATCATAAGGA
ATACTAATAGCTACCAACG -> TACTAATAGCTACCAACGG
ATACTGGTTCCTCCGAAAC -> TACTGGTTCCTCCGAAACC
ATACTTGACACTTCATGCT -> TACTTGACACTTCATGCTG
ATACTTTTATCTGCGCGTG -> TACTTTTATCTGCGCGTGC
ATAGATGATGGTGACACCG -> TAGATGATGGTGACACCGG
ATAGATGGGGCTAGAGAGA -> TAGATGGGGCTAGAGAGAG
ATAGCCGGTCCGACATATG -> TAGCCGGTCCGACATATGA
ATAGCGCTTGGAAGTGGGG -> TAGCGCTTGGAAGTGGGGA
ATAGCTAACCGGCACTCCT -> TAGCTAACCGGCACTCCTC
ATAGCTACCAACGGGGGTC -> TAGCTACCAACGGGGGTCT
ATAGGTCGCAGCATTTAAT -> TAGGTCGCAGCATTTAATG
ATAGTCCCTGTTTGCACTG -> TAGTCCCTGTTTGCACTGA
ATATAAGTCTGTAAATAGT -> TATAAGTCTGTAAATAGTC
ATATACTAACAAATCATAA -> TATACTAACAAATCATAAG
ATATACTTTTATCTGCGCG -> TATACTTTTATCTGCGCGT
ATATCGCGTGGGGAGTAGT -> TATCGCGTGGGGAGTAGTG
ATATGAAATTATGTGCGAG -> TATGAAATTATGTGCGAGC
ATATGAGGTATGAAGGGTT -> TATGAGGTATGAAGGGTTG
ATATGCCGTGGCGGATGGA -> TATGCCGTGGCGGATGGAC
ATATGGGGGGGGTCAAATA -> TATGGGGGGGGTCAAATAA
ATATTCATTCGGCTTCAGA -> TATTCATTCGGCTTCAGAG
ATATTTATAATTGGAAGGC -> TATTTATAATTGGAAGGCG
ATCAAAGAGGTGGAATGGG -> TCAAAGAGGTGGAATGGGT
ATCAAGATAATATGAGGTA -> TCAAGATAATATGAGGTAT
ATCAATATGCCGTGGCGGA -> TCAATATGCCGTGGCGGAT
ATCACGGGTCCCAGAAGTT -> TCACGGGTCCCAGAAGTTA
ATCATAAGGATGCGATCGC -> TCATAAGGATGCGATCGCC
ATCCAACAACCGTGCGCAT -> TCCAACAACCGTGCGCATC
ATCCATCAATATGCCGTGG -> TCCATCAATATGCCGTGGC
ATCCCCCTTTAACGCGCAT -> TCCCCCTTTAACGCGCATG
ATCCGCAGAAAAGAGTCCT -> TCCGCAGAAAAGAGTCCTC
ATCCTACCATACCGCCAAA -> TCCTACCATACCGCCAAAA
ATCCTAGCACCTCAATATA -> TCCTAGCACCTCAATATAA
ATCGAATTGCTGGCGTTAA -> TCGAATTGCTGGCGTTAAA
ATCGACTTAGTCGGAATAT -> TCGACTTAGTCGGAATATG
ATCGATAGCCGGTCCGACA -> TCGATAGCCGGTCCGACAT
ATCGCCGAAAGTGGGTACA -> TCGCCGAAAGTGGGTACAA
ATCGCCGTATTAAGGGTCC -> TCGCCGTATTAAGGGTCCA
ATCGCGTGGGGAGTAGTGC -> TCGCGTGGGGAGTAGTGCT
ATCGGTTTTGCGGCCAACA -> TCGGTTTTGCGGCCAACAC
ATCGTAATCTAAATTACCT -> TCGTAATCTAAATTACCTC
ATCGTACTAAAGCGTAACC -> TCGTACTAAAGCGTAACCG
ATCGTAGGCTCACAAATCC -> TCGTAGGCTCACAAATCCC
ATCGTATTTTTACAGCTAT -> TCGTATTTTTACAGCTATG
ATCGTTCCTGCCGTAGTCG -> TCGTTCCTGCCGTAGTCGT
ATCTAAATTACCTCGGAAA -> TCTAAATTACCTCGGAAAC
ATCTAGAGAGAGATATCGC -> TCTAGAGAGAGATATCGCG
ATCTCGAGAAGCGGTACAG -> TCTCGAGAAGCGGTACAGA
ATCTCGGAAAAGGAGGCCA -> TCTCGGAAAAGGAGGCCAT
ATCTGCAACTGTAATGAAA -> TCTGCAACTGTAATGAAAA
ATCTGCGCGTGCCACATAT -> TCTGCGCGTGCCACATATT
ATCTTACACGGACCATACG -> TCTTACACGGACCATACGG
ATCTTAGAGTTACGGGTTC -> TCTTAGAGTTACGGGTTCC
ATCTTGCGATTATCTGCAA -> TCTTGCGATTATCTGCAAC
ATCTTTCGGAACTGCTCTT -> TCTTTCGGAACTGCTCTTT
ATGAAAAGGCACTCTATGG -> TGAAAAGGCACTCTATGGG
ATGAAATTATGTGCGAGCT -> TGAAATTATGTGCGAGCTT
ATGAAGGGTTGAACAAAGG -> TGAAGGGTTGAACAAAGGA
ATGAATACTTGACACTTCA -> TGAATACTTGACACTTCAT
ATGACGGTAGGTAGAAGTT -> TGACGGTAGGTAGAAGTTA
ATGACTGAGAGAATGAGTG -> TGACTGAGAGAATGAGTGC
ATGAGGTATGAAGGGTTGA -> TGAGGTATGAAGGGTTGAA
ATGAGGTCGATGTGTCCCT -> TGAGGTCGATGTGTCCCTT
ATGAGTGCATCGTAATCTA -> TGAGTGCATCGTAATCTAA
ATGATGGTGACACCGGTTG -> TGATGGTGACACCGGTTGT
ATGCACGGCCACTTGGCTG -> TGCACGGCCACTTGGCTGT
ATGCACTACAAGTCACGGC -> TGCACTACAAGTCACGGCT
ATGCATTGTGGACGGACAG -> TGCATTGTGGACGGACAGG
ATGCCCTGCACTCTTCTAC -> TGCCCTGCACTCTTCTACC
ATGCCGAAGAAGGTGTGTC -> TGCCGAAGAAGGTGTGTCA
ATGCCGTGGCGGATGGACC -> TGCCGTGGCGGATGGACCC
ATGCCTCGGAAAATCTTGC -> TGCCTCGGAAAATCTTGCG
ATGCGACTGGTCTTCATAC -> TGCGACTGGTCTTCATACT
ATGCGATCGCCGTATTAAG -> TGCGATCGCCGTATTAAGG
ATGCGGGAAGCTAGGCGGT -> TGCGGGAAGCTAGGCGGTC
ATGCTCGATGGGCCACACG -> TGCTCGATGGGCCACACGT
ATGCTCTTTATAGATGGGG -> TGCTCTTTATAGATGGGGC
ATGCTGTGCTAAGTTGAGA -> TGCTGTGCTAAGTTGAGAC
ATGGACCCAAATCCAACAA -> TGGACCCAAATCCAACAAC
ATGGCAATAGCTAACCGGC -> TGGCAATAGCTAACCGGCA
ATGGGAATCTCGAGAAGCG -> TGGGAATCTCGAGAAGCGG
ATGGGAGAAGTTACCTGCG -> TGGGAGAAGTTACCTGCGC
ATGGGCCACACGTCGACCT -> TGGGCCACACGTCGACCTT
ATGGGGCTAGAGAGAGTCC -> TGGGGCTAGAGAGAGTCCA
ATGGGGGGGGTCAAATAAA -> TGGGGGGGGTCAAATAAAA
ATGGGTGGTAATTGGCTAT -> TGGGTGGTAATTGGCTATT
ATGGTACTTCAGAATAGAT -> TGGTACTTCAGAATAGATG
ATGGTGACACCGGTTGTCG -> TGGTGACACCGGTTGTCGG
ATGTAATTAAGTCCCTGCG -> TGTAATTAAGTCCCTGCGG
ATGTAGCAACGTGTGCTAA -> TGTAGCAACGTGTGCTAAA
ATGTAGGAAAATCTCGGAA -> TGTAGGAAAATCTCGGAAA
ATGTCCCACCGGGATTAAT -> TGTCCCACCGGGATTAATC
ATGTCCGTCGGAACTAAAC -> TGTCCGTCGGAACTAAACG
ATGTGCGAGCTTGTCGGCC -> TGTGCGAGCTTGTCGGCCG
ATGTGTCCCTTGCATAGCG -> TGTGTCCCTTGCATAGCGC
ATGTTGTCAAATAAATAAT -> TGTTGTCAAATAAATAATA
ATTAAACACCCGATTATTG -> TTAAACACCCGATTATTGT
ATTAAAGACGGGCTATCGT -> TTAAAGACGGGCTATCGTA
ATTAAAGCCGAGCTCGTAT -> TTAAAGCCGAGCTCGTATT
ATTAAGGGTCCAGACCCAT -> TTAAGGGTCCAGACCCATG
ATTAAGTCCCTGCGGTTAT -> TTAAGTCCCTGCGGTTATA
ATTAATCCATCAATATGCC -> TTAATCCATCAATATGCCG
ATTAATCCTACCATACCGC -> TTAATCCTACCATACCGCC
ATTACCTCGGAAACCCAAC -> TTACCTCGGAAACCCAACC
ATTAGAAAGCAGACAGCGT -> TTAGAAAGCAGACAGCGTG
ATTATCTGCAACTGTAATG -> TTATCTGCAACTGTAATGA
ATTATGTGCGAGCTTGTCG -> TTATGTGCGAGCTTGTCGG
ATTATTGTGGGTTTAGAGA -> TTATTGTGGGTTTAGAGAC
ATTCATTCGGCTTCAGAGA -> TTCATTCGGCTTCAGAGAC
ATTCGCAAGCTTAATATAC -> TTCGCAAGCTTAATATACT
ATTCGCGGTGCTGTAAGGA -> TTCGCGGTGCTGTAAGGAT
ATTCGGCTTCAGAGACCGA -> TTCGGCTTCAGAGACCGAT
ATTCTGACCCCCAACTGCC -> TTCTGACCCCCAACTGCCG
ATTGAAGAACTATCAAAGA -> TTGAAGAACTATCAAAGAG
ATTGCGACACCGGCTGACT -> TTGCGACACCGGCTGACTA
ATTGCTGACCTATTAGAAA -> TTGCTGACCTATTAGAAAG
ATTGCTGGCGTTAAACGGT -> TTGCTGGCGTTAAACGGTG
ATTGGAAGGCGAAGCGAAT -> TTGGAAGGCGAAGCGAATT
ATTGGCTATTCTGACCCCC -> TTGGCTATTCTGACCCCCA
ATTGTCGGCCGAGTGAAAT -> TTGTCGGCCGAGTGAAATA
ATTGTGGACGGACAGGTGG -> TTGTGGACGGACAGGTGGC
ATTGTGGGTTTAGAGACCC -> TTGTGGGTTTAGAGACCCG
ATTTAATGAGGTCGATGTG -> TTTAATGAGGTCGATGTGT
ATTTAGGGGATCTTTCGGA -> TTTAGGGGATCTTTCGGAA
ATTTATAATTGGAAGGCGA -> TTTATAATTGGAAGGCGAA
ATTTCTGTATGCTCGATGG -> TTTCTGTATGCTCGATGGG
ATTTGCTGGATTGAAGAAC -> TTTGCTGGATTGAAGAACT
ATTTGGGATGGGAGAAGTT -> TTTGGGATGGGAGAAGTTA
ATTTTTACAGCTATGCGGG -> TTTTTACAGCTATGCGGGA
CAAAACTAAGGCACGCCAT -> AAAACTAAGGCACGCCATA
CAAACCGTCGAAGTTACCT -> AAACCGTCGAAGTTACCTG
CAAACTAGGGCAACTTTGG -> AAACTAGGGCAACTTTGGG
CAAAGAGGTGGAATGGGTG -> AAAGAGGTGGAATGGGTGG
CAAAGGAAGAGGTCGGGGC -> AAAGGAAGAGGTCGGGGCA
CAAATAAAATCGATAGCCG -> AAATAAAATCGATAGCCGG
CAAATAAATAATACTGGTT -> AAATAAATAATACTGGTTC
CAAATCATAAGGATGCGAT -> AAATCATAAGGATGCGATC
CAAATCCAACAACCGTGCG -> AAATCCAACAACCGTGCGC
CAAATCCCCCTTTAACGCG -> AAATCCCCCTTTAACGCGC
CAAATCTTACACGGACCAT -> AAATCTTACACGGACCATA
CAACAACCGTGCGCATCGT -> AACAACCGTGCGCATCGTA
CAACACTATGCCTCGGAAA -> AACACTATGCCTCGGAAAA
CAACCCCGCATGTAGGAAA -> AACCCCGCATGTAGGAAAA
CAACCCCGGTGACATTAAA -> AACCCCGGTGACATTAAAG
CAACCGAGATGGTACTTCA -> AACCGAGATGGTACTTCAG
CAACCGTGCGCATCGTAGG -> AACCGTGCGCATCGTAGGC
CAACGGGGAGGGCCAACCC -> AACGGGGAGGGCCAACCCC
CAACGGGGGTCTGGTTGTT -> AACGGGGGTCTGGTTGTTG
CAACGTGTGCTAAACGAAC -> AACGTGTGCTAAACGAACC
CAACTGCCGTCCACATCGC -> AACTGCCGTCCACATCGCC
CAACTGTAATGAAAAGGCA -> AACTGTAATGAAAAGGCAC
CAACTTTGGGAGATTCGCG -> AACTTTGGGAGATTCGCGG
CAAGATAATATGAGGTATG -> AAGATAATATGAGGTATGA
CAAGCACGAATCTAGAGAG -> AAGCACGAATCTAGAGAGA
CAAGCTTAATATACTTTTA -> AAGCTTAATATACTTTTAT
CAAGCTTTGAAAGCCCGTT -> AAGCTTTGAAAGCCCGTTA
CAAGGCGCTTGTCCTATGC -> AAGGCGCTTGTCCTATGCA
CAAGTCACGGCTAATAAAT -> AAGTCACGGCTAATAAATT
CAATAGCTAACCGGCACTC -> AATAGCTAACCGGCACTCC
CAATATAAGTCTGTAAATA -> AATATAAGTCTGTAAATAG
CAATATGCCGTGGCGGATG -> AATATGCCGTGGCGGATGG
CAATCCGCAGAAAAGAGTC -> AATCCGCAGAAAAGAGTCC
CAATTTAGGGGATCTTTCG -> AATTTAGGGGATCTTTCGG
CACAAATCCCCCTTTAACG -> ACAAATCCCCCTTTAACGC
CACACGTCGACCTTCTCTT -> ACACGTCGACCTTCTCTTT
CACACTATAGGTCGCAGCA -> ACACTATAGGTCGCAGCAT
CACATATTTATAATTGGAA -> ACATATTTATAATTGGAAG
CACATCGCCGAAAGTGGGT -> ACATCGCCGAAAGTGGGTA
CACATCGTACTAAAGCGTA -> ACATCGTACTAAAGCGTAA
CACCCGATTATTGTGGGTT -> ACCCGATTATTGTGGGTTT
CACCGGCTGACTATCGAAT -> ACCGGCTGACTATCGAATT
CACCGGGATTAATCCTACC -> ACCGGGATTAATCCTACCA
CACCGGTTGTCGGCCGAGT -> ACCGGTTGTCGGCCGAGTG
CACCTCAATATAAGTCTGT -> ACCTCAATATAAGTCTGTA
CACCTCGGAGATCGGTTTT -> ACCTCGGAGATCGGTTTTG
CACCTGCAGGTGGGCACGA -> ACCTGCAGGTGGGCACGAG
CACGAATCTAGAGAGAGAT -> ACGAATCTAGAGAGAGATA
CACGAGCGTCATTAAAGAC -> ACGAGCGTCATTAAAGACG
CACGCCATATACTAACAAA -> ACGCCATATACTAACAAAT
CACGCGAATTCGCAAGCTT -> ACGCGAATTCGCAAGCTTA
CACGGACCATACGGTGATA -> ACGGACCATACGGTGATAC
CACGGCCACTTGGCTGTAT -> ACGGCCACTTGGCTGTATT
CACGGCTAATAAATTGCGA -> ACGGCTAATAAATTGCGAC
CACGGGCGGGGATCGACTT -> ACGGGCGGGGATCGACTTA
CACGGGTCCCAGAAGTTAC -> ACGGGTCCCAGAAGTTACC
CACGTCGACCTTCTCTTTG -> ACGTCGACCTTCTCTTTGA
CACTAAGACTGCAATTTAG -> ACTAAGACTGCAATTTAGG
CACTACAAGTCACGGCTAA -> ACTACAAGTCACGGCTAAT
CACTACGCACTAAGACTGC -> ACTACGCACTAAGACTGCA
CACTATAGGTCGCAGCATT -> ACTATAGGTCGCAGCATTT
CACTATGCCTCGGAAAATC -> ACTATGCCTCGGAAAATCT
CACTCCGGCCGTCTAGTAG -> ACTCCGGCCGTCTAGTAGT
CACTCCTCTACCTTGACAA -> ACTCCTCTACCTTGACAAC
CACTCTATGGGAATCTCGA -> ACTCTATGGGAATCTCGAG
CACTCTTCTACCCGGTCTA -> ACTCTTCTACCCGGTCTAG
CACTGAGTACAAGCACGAA -> ACTGAGTACAAGCACGAAT
CACTTCATGCTGTGCTAAG -> ACTTCATGCTGTGCTAAGT
CACTTGGCTGTATTAAACA -> ACTTGGCTGTATTAAACAC
CAGAAAAGAGTCCTCCAAC -> AGAAAAGAGTCCTCCAACC
CAGAAGTTACCTGCGCGGT -> AGAAGTTACCTGCGCGGTC
CAGAATAGATGATGGTGAC -> AGAATAGATGATGGTGACA
CAGACAGCGTGTGTACACT -> AGACAGCGTGTGTACACTA
CAGACCCATGCCCTGCACT -> AGACCCATGCCCTGCACTC
CAGACGTTTTTGTCGGCCG -> AGACGTTTTTGTCGGCCGA
CAGAGACCGATGACTGAGA -> AGAGACCGATGACTGAGAG
CAGCATGTTGTCAAATAAA -> AGCATGTTGTCAAATAAAT
CAGCATTTAATGAGGTCGA -> AGCATTTAATGAGGTCGAT
CAGCGTGTGTACACTACGC -> AGCGTGTGTACACTACGCA
CAGCTATGCGGGAAGCTAG -> AGCTATGCGGGAAGCTAGG
CAGGTGGCGACGTGTTCTT -> AGGTGGCGACGTGTTCTTG
CAGGTGGGCACGAGCGTCA -> AGGTGGGCACGAGCGTCAT
CATAAGGATGCGATCGCCG -> ATAAGGATGCGATCGCCGT
CATACCGCCAAAACTAAGG -> ATACCGCCAAAACTAAGGC
CATACGGTGATACCCTACA -> ATACGGTGATACCCTACAC
CATACTAATAGCTACCAAC -> ATACTAATAGCTACCAACG
CATAGCGCTTGGAAGTGGG -> ATAGCGCTTGGAAGTGGGG
CATATACTAACAAATCATA -> ATATACTAACAAATCATAA
CATATGAAATTATGTGCGA -> ATATGAAATTATGTGCGAG
CATATTTATAATTGGAAGG -> ATATTTATAATTGGAAGGC
CATCAATATGCCGTGGCGG -> ATCAATATGCCGTGGCGGA
CATCCTAGCACCTCAATAT -> ATCCTAGCACCTCAATATA
CATCGCCGAAAGTGGGTAC -> ATCGCCGAAAGTGGGTACA
CATCGTAATCTAAATTACC -> ATCGTAATCTAAATTACCT
CATCGTACTAAAGCGTAAC -> ATCGTACTAAAGCGTAACC
CATCGTAGGCTCACAAATC -> ATCGTAGGCTCACAAATCC
CATGCACGGCCACTTGGCT -> ATGCACGGCCACTTGGCTG
CATGCCCTGCACTCTTCTA -> ATGCCCTGCACTCTTCTAC
CATGCCGAAGAAGGTGTGT -> ATGCCGAAGAAGGTGTGTC
CATGCTCTTTATAGATGGG -> ATGCTCTTTATAGATGGGG
CATGCTGTGCTAAGTTGAG -> ATGCTGTGCTAAGTTGAGA
CATGTAGGAAAATCTCGGA -> ATGTAGGAAAATCTCGGAA
CATGTCCCACCGGGATTAA -> ATGTCCCACCGGGATTAAT
CATGTTGTCAAATAAATAA -> ATGTTGTCAAATAAATAAT
CATTAAAGACGGGCTATCG -> ATTAAAGACGGGCTATCGT
CATTAAAGCCGAGCTCGTA -> ATTAAAGCCGAGCTCGTAT
CATTCGGCTTCAGAGACCG -> ATTCGGCTTCAGAGACCGA
CATTGTGGACGGACAGGTG -> ATTGTGGACGGACAGGTGG
CATTTAATGAGGTCGATGT -> ATTTAATGAGGTCGATGTG
CATTTCTGTATGCTCGATG -> ATTTCTGTATGCTCGATGG
CCAAAACTAAGGCACGCCA -> CAAAACTAAGGCACGCCAT
CCAAACCGTCGAAGTTACC -> CAAACCGTCGAAGTTACCT
CCAAACTAGGGCAACTTTG -> CAAACTAGGGCAACTTTGG
CCAAATCCAACAACCGTGC -> CAAATCCAACAACCGTGCG
CCAACAACCGTGCGCATCG -> CAACAACCGTGCGCATCGT
CCAACACTATGCCTCGGAA -> CAACACTATGCCTCGGAAA
CCAACCCCGCATGTAGGAA -> CAACCCCGCATGTAGGAAA
CCAACCCCGGTGACATTAA -> CAACCCCGGTGACATTAAA
CCAACCGAGATGGTACTTC -> CAACCGAGATGGTACTTCA
CCAACGGGGGTCTGGTTGT -> CAACGGGGGTCTGGTTGTT
CCAACTGCCGTCCACATCG -> CAACTGCCGTCCACATCGC
CCACACGTCGACCTTCTCT -> CACACGTCGACCTTCTCTT
CCACACTATAGGTCGCAGC -> CACACTATAGGTCGCAGCA
CCACATATTTATAATTGGA -> CACATATTTATAATTGGAA
CCACATCGCCGAAAGTGGG -> CACATCGCCGAAAGTGGGT
CCACCGGGATTAATCCTAC -> CACCGGGATTAATCCTACC
CCACGGGCGGGGATCGACT -> CACGGGCGGGGATCGACTT
CCACTTGGCTGTATTAAAC -> CACTTGGCTGTATTAAACA
CCAGAAGTTACCTGCGCGG -> CAGAAGTTACCTGCGCGGT
CCAGACCCATGCCCTGCAC -> CAGACCCATGCCCTGCACT
CCATACCGCCAAAACTAAG -> CATACCGCCAAAACTAAGG
CCATACGGTGATACCCTAC -> CATACGGTGATACCCTACA
CCATATACTAACAAATCAT -> CATATACTAACAAATCATA
CCATCAATATGCCGTGGCG -> CATCAATATGCCGTGGCGG
CCATGCACGGCCACTTGGC -> CATGCACGGCCACTTGGCT
CCATGCCCTGCACTCTTCT -> CATGCCCTGCACTCTTCTA
CCATGCTCTTTATAGATGG -> CATGCTCTTTATAGATGGG
CCCAAATCCAACAACCGTG -> CCAAATCCAACAACCGTGC
CCCAACCCCGCATGTAGGA -> CCAACCCCGCATGTAGGAA
CCCAACTGCCGTCCACATC -> CCAACTGCCGTCCACATCG
CCCACCGGGATTAATCCTA -> CCACCGGGATTAATCCTAC
CCCACGGGCGGGGATCGAC -> CCACGGGCGGGGATCGACT
CCCAGAAGTTACCTGCGCG -> CCAGAAGTTACCTGCGCGG
CCCATGCCCTGCACTCTTC -> CCATGCCCTGCACTCTTCT
CCCATGCTCTTTATAGATG -> CCATGCTCTTTATAGATGG
CCCCAACTGCCGTCCACAT -> CCCAACTGCCGTCCACATC
CCCCCAACTGCCGTCCACA -> CCCCAACTGCCGTCCACAT
CCCCCTTTAACGCGCATGC -> CCCCTTTAACGCGCATGCC
CCCCGCATGTAGGAAAATC -> CCCGCATGTAGGAAAATCT
CCCCGGTGACATTAAAGCC -> CCCGGTGACATTAAAGCCG
CCCCTTTAACGCGCATGCC -> CCCTTTAACGCGCATGCCG
CCCGATTATTGTGGGTTTA -> CCGATTATTGTGGGTTTAG
CCCGCATGTAGGAAAATCT -> CCGCATGTAGGAAAATCTC
CCCGCGGGAGGCCCATGCT -> CCGCGGGAGGCCCATGCTC
CCCGGTGACATTAAAGCCG -> CCGGTGACATTAAAGCCGA
CCCGTGTACTTTAGCGGCG -> CCGTGTACTTTAGCGGCGC
CCCGTTAAATCTTAGAGTT -> CCGTTAAATCTTAGAGTTA
CCCTAATCAAGATAATATG -> CCTAATCAAGATAATATGA
CCCTACACCTGCAGGTGGG -> CCTACACCTGCAGGTGGGC
CCCTGAACTATAATGCACT -> CCTGAACTATAATGCACTA
CCCTGCACTCTTCTACCCG -> CCTGCACTCTTCTACCCGG
CCCTGCGGTTATAAACACT -> CCTGCGGTTATAAACACTC
CCCTGTTTGCACTGAGTAC -> CCTGTTTGCACTGAGTACA
CCCTTGCATAGCGCTTGGA -> CCTTGCATAGCGCTTGGAA
CCCTTTAACGCGCATGCCG -> CCTTTAACGCGCATGCCGA
CCGAAACCACACTATAGGT -> CGAAACCACACTATAGGTC
CCGAAAGTGGGTACAATCC -> CGAAAGTGGGTACAATCCG
CCGAAGAAGGTGTGTCATG -> CGAAGAAGGTGTGTCATGT
CCGACATATGAAATTATGT -> CGACATATGAAATTATGTG
CCGAGATGGTACTTCAGAA -> CGAGATGGTACTTCAGAAT
CCGAGCTCGTATTGTCGGC -> CGAGCTCGTATTGTCGGCC
CCGAGTGAAATACCAAACC -> CGAGTGAAATACCAAACCG
CCGAGTGAAATCACGGGTC -> CGAGTGAAATCACGGGTCC
CCGAGTGAAATGACGGTAG -> CGAGTGAAATGACGGTAGG
CCGAGTGAAATTTGGGATG -> CGAGTGAAATTTGGGATGG
CCGATGACTGAGAGAATGA -> CGATGACTGAGAGAATGAG
CCGATTATTGTGGGTTTAG -> CGATTATTGTGGGTTTAGA
CCGCAGAAAAGAGTCCTCC -> CGCAGAAAAGAGTCCTCCA
CCGCATGTAGGAAAATCTC -> CGCATGTAGGAAAATCTCG
CCGCCAAAACTAAGGCACG -> CGCCAAAACTAAGGCACGC
CCGCCGTTCCCTAATCAAG -> CGCCGTTCCCTAATCAAGA
CCGCGGGAGGCCCATGCTC -> CGCGGGAGGCCCATGCTCT
CCGGCACTCCTCTACCTTG -> CGGCACTCCTCTACCTTGA
CCGGCCGTCTAGTAGTGGA -> CGGCCGTCTAGTAGTGGAC
CCGGCTGACTATCGAATTG -> CGGCTGACTATCGAATTGC
CCGGGATTAATCCTACCAT -> CGGGATTAATCCTACCATA
CCGGTCCGACATATGAAAT -> CGGTCCGACATATGAAATT
CCGGTGACATTAAAGCCGA -> CGGTGACATTAAAGCCGAG
CCGGTTGTCGGCCGAGTGA -> CGGTTGTCGGCCGAGTGAA
CCGTAGTCGTGAATTTGCT -> CGTAGTCGTGAATTTGCTG
CCGTATTAAGGGTCCAGAC -> CGTATTAAGGGTCCAGACC
CCGTCCACATCGCCGAAAG -> CGTCCACATCGCCGAAAGT
CCGTCGAAGTTACCTGCGC -> CGTCGAAGTTACCTGCGCG
CCGTCGGAACTAAACGGTG -> CGTCGGAACTAAACGGTGC
CCGTCGGGTTTGAAACGCG -> CGTCGGGTTTGAAACGCGG
CCGTCTAGTAGTGGACATC -> CGTCTAGTAGTGGACATCC
CCGTGCGCATCGTAGGCTC -> CGTGCGCATCGTAGGCTCA
CCGTGGCGGATGGACCCAA -> CGTGGCGGATGGACCCAAA
CCGTGTACTTTAGCGGCGC -> CGTGTACTTTAGCGGCGCC
CCGTTAAATCTTAGAGTTA -> CGTTAAATCTTAGAGTTAC
CCGTTCCCTAATCAAGATA -> CGTTCCCTAATCAAGATAA
CCTAATCAAGATAATATGA -> CTAATCAAGATAATATGAG
CCTACACCTGCAGGTGGGC -> CTACACCTGCAGGTGGGCA
CCTACCATACCGCCAAAAC -> CTACCATACCGCCAAAACT
CCTAGACCCACGGGCGGGG -> CTAGACCCACGGGCGGGGA
CCTAGCACCTCAATATAAG -> CTAGCACCTCAATATAAGT
CCTATGCATTGTGGACGGA -> CTATGCATTGTGGACGGAC
CCTATTAATCCATCAATAT -> CTATTAATCCATCAATATG
CCTATTAGAAAGCAGACAG -> CTATTAGAAAGCAGACAGC
CCTCAAATCTTACACGGAC -> CTCAAATCTTACACGGACC
CCTCAATATAAGTCTGTAA -> CTCAATATAAGTCTGTAAA
CCTCCAACCGAGATGGTAC -> CTCCAACCGAGATGGTACT
CCTCCGAAACCACACTATA -> CTCCGAAACCACACTATAG
CCTCGGAAAATCTTGCGAT -> CTCGGAAAATCTTGCGATT
CCTCGGAAACCCAACCCCG -> CTCGGAAACCCAACCCCGC
CCTCGGAGATCGGTTTTGC -> CTCGGAGATCGGTTTTGCG
CCTCTACCTTGACAACGGG -> CTCTACCTTGACAACGGGG
CCTGAACTATAATGCACTA -> CTGAACTATAATGCACTAC
CCTGCACTCTTCTACCCGG -> CTGCACTCTTCTACCCGGT
CCTGCAGGTGGGCACGAGC -> CTGCAGGTGGGCACGAGCG
CCTGCCGTAGTCGTGAATT -> CTGCCGTAGTCGTGAATTT
CCTGCGCGGTCTATGTCCG -> CTGCGCGGTCTATGTCCGT
CCTGCGCGGTCTCTCGCGG -> CTGCGCGGTCTCTCGCGGC
CCTGCGCGGTCTTCTGGGA -> CTGCGCGGTCTTCTGGGAG
CCTGCGCGGTCTTCTTTAC -> CTGCGCGGTCTTCTTTACA
CCTGCGGTTATAAACACTC -> CTGCGGTTATAAACACTCC
CCTGTTTGCACTGAGTACA -> CTGTTTGCACTGAGTACAA
CCTTCTCTTTGAACCCGCG -> CTTCTCTTTGAACCCGCGG
CCTTGACAACGGGGAGGGC -> CTTGACAACGGGGAGGGCC
CCTTGCATAGCGCTTGGAA -> CTTGCATAGCGCTTGGAAG
CCTTTAACGCGCATGCCGA -> CTTTAACGCGCATGCCGAA
CGAAACCACACTATAGGTC -> GAAACCACACTATAGGTCG
CGAAAGTGGGTACAATCCG -> GAAAGTGGGTACAATCCGC
CGAACCCTGAACTATAATG -> GAACCCTGAACTATAATGC
CGAAGAAGGTGTGTCATGT -> GAAGAAGGTGTGTCATGTC
CGAAGCGAATTGCTGACCT -> GAAGCGAATTGCTGACCTA
CGAAGTTACCTGCGCGGTC -> GAAGTTACCTGCGCGGTCT
CGAATCTAGAGAGAGATAT -> GAATCTAGAGAGAGATATC
CGAATTCGCAAGCTTAATA -> GAATTCGCAAGCTTAATAT
CGAATTGCTGACCTATTAG -> GAATTGCTGACCTATTAGA
CGAATTGCTGGCGTTAAAC -> GAATTGCTGGCGTTAAACG
CGACACCGGCTGACTATCG -> GACACCGGCTGACTATCGA
CGACATATGAAATTATGTG -> GACATATGAAATTATGTGC
CGACCTTCTCTTTGAACCC -> GACCTTCTCTTTGAACCCG
CGACGTGTTCTTGCGCGAG -> GACGTGTTCTTGCGCGAGC
CGACTGGTCTTCATACTAA -> GACTGGTCTTCATACTAAT
CGACTTAGTCGGAATATGG -> GACTTAGTCGGAATATGGG
CGAGAAGCGGTACAGACGT -> GAGAAGCGGTACAGACGTT
CGAGATGGTACTTCAGAAT -> GAGATGGTACTTCAGAATA
CGAGCACCTCGGAGATCGG -> GAGCACCTCGGAGATCGGT
CGAGCGTCATTAAAGACGG -> GAGCGTCATTAAAGACGGG
CGAGCTCGTATTGTCGGCC -> GAGCTCGTATTGTCGGCCG
CGAGCTTGTCGGCCGAGTG -> GAGCTTGTCGGCCGAGTGA
CGAGTGAAATACCAAACCG -> GAGTGAAATACCAAACCGT
CGAGTGAAATCACGGGTCC -> GAGTGAAATCACGGGTCCC
CGAGTGAAATGACGGTAGG -> GAGTGAAATGACGGTAGGT
CGAGTGAAATTTGGGATGG -> GAGTGAAATTTGGGATGGG
CGATAGCCGGTCCGACATA -> GATAGCCGGTCCGACATAT
CGATCGCCGTATTAAGGGT -> GATCGCCGTATTAAGGGTC
CGATGACTGAGAGAATGAG -> GATGACTGAGAGAATGAGT
CGATGGGCCACACGTCGAC -> GATGGGCCACACGTCGACC
CGATGTAGCAACGTGTGCT -> GATGTAGCAACGTGTGCTA
CGATGTGTCCCTTGCATAG -> GATGTGTCCCTTGCATAGC
CGATTATCTGCAACTGTAA -> GATTATCTGCAACTGTAAT
CGATTATTGTGGGTTTAGA -> GATTATTGTGGGTTTAGAG
CGCAAGCTTAATATACTTT -> GCAAGCTTAATATACTTTT
CGCACTAAGACTGCAATTT -> GCACTAAGACTGCAATTTA
CGCAGAAAAGAGTCCTCCA -> GCAGAAAAGAGTCCTCCAA
CGCAGCATTTAATGAGGTC -> GCAGCATTTAATGAGGTCG
CGCATCGTAGGCTCACAAA -> GCATCGTAGGCTCACAAAT
CGCATGCCGAAGAAGGTGT -> GCATGCCGAAGAAGGTGTG
CGCATGTAGGAAAATCTCG -> GCATGTAGGAAAATCTCGG
CGCCAAAACTAAGGCACGC -> GCCAAAACTAAGGCACGCC
CGCCATATACTAACAAATC -> GCCATATACTAACAAATCA
CGCCGAAAGTGGGTACAAT -> GCCGAAAGTGGGTACAATC
CGCCGTATTAAGGGTCCAG -> GCCGTATTAAGGGTCCAGA
CGCCGTTCCCTAATCAAGA -> GCCGTTCCCTAATCAAGAT
CGCCTATTAATCCATCAAT -> GCCTATTAATCCATCAATA
CGCCTCAAATCTTACACGG -> GCCTCAAATCTTACACGGA
CGCGAATTCGCAAGCTTAA -> GCGAATTCGCAAGCTTAAT
CGCGAGCACCTCGGAGATC -> GCGAGCACCTCGGAGATCG
CGCGCATGCCGAAGAAGGT -> GCGCATGCCGAAGAAGGTG
CGCGGCTGTTACGATGTAG -> GCGGCTGTTACGATGTAGC
CGCGGGAGGCCCATGCTCT -> GCGGGAGGCCCATGCTCTT
CGCGGTCTATGTCCGTCGG -> GCGGTCTATGTCCGTCGGA
CGCGGTCTCTCGCGGCTGT -> GCGGTCTCTCGCGGCTGTT
CGCGGTCTTCTGGGAGAAA -> GCGGTCTTCTGGGAGAAAT
CGCGGTCTTCTTTACACAT -> GCGGTCTTCTTTACACATC
CGCGGTGCTGTAAGGATAT -> GCGGTGCTGTAAGGATATT
CGCGGTTGCGGAGGATGCG -> GCGGTTGCGGAGGATGCGA
CGCGTGCCACATATTTATA -> GCGTGCCACATATTTATAA
CGCGTGGGGAGTAGTGCTC -> GCGTGGGGAGTAGTGCTCA
CGCTTGGAAGTGGGGACGG -> GCTTGGAAGTGGGGACGGA
CGCTTGTCCTATGCATTGT -> GCTTGTCCTATGCATTGTG
CGGAAAAGGAGGCCATGCA -> GGAAAAGGAGGCCATGCAC
CGGAAAATCTTGCGATTAT -> GGAAAATCTTGCGATTATC
CGGAAACCCAACCCCGCAT -> GGAAACCCAACCCCGCATG
CGGAACTAAACGGTGCTCA -> GGAACTAAACGGTGCTCAT
CGGAACTGCTCTTTTCTCA -> GGAACTGCTCTTTTCTCAA
CGGAATATGGGGGGGGTCA -> GGAATATGGGGGGGGTCAA
CGGACAGGTGGCGACGTGT -> GGACAGGTGGCGACGTGTT
CGGACCATACGGTGATACC -> GGACCATACGGTGATACCC
CGGAGAATGAATACTTGAC -> GGAGAATGAATACTTGACA
CGGAGATCGGTTTTGCGGC -> GGAGATCGGTTTTGCGGCC
CGGAGGATGCGACTGGTCT -> GGAGGATGCGACTGGTCTT
CGGATGGACCCAAATCCAA -> GGATGGACCCAAATCCAAC
CGGCACTCCTCTACCTTGA -> GGCACTCCTCTACCTTGAC
CGGCCAACACTATGCCTCG -> GGCCAACACTATGCCTCGG
CGGCCACTTGGCTGTATTA -> GGCCACTTGGCTGTATTAA
CGGCCGAGTGAAATACCAA -> GGCCGAGTGAAATACCAAA
CGGCCGAGTGAAATCACGG -> GGCCGAGTGAAATCACGGG
CGGCCGAGTGAAATGACGG -> GGCCGAGTGAAATGACGGT
CGGCCGAGTGAAATTTGGG -> GGCCGAGTGAAATTTGGGA
CGGCCGTCTAGTAGTGGAC -> GGCCGTCTAGTAGTGGACA
CGGCGCCTATTAATCCATC -> GGCGCCTATTAATCCATCA
CGGCTAATAAATTGCGACA -> GGCTAATAAATTGCGACAC
CGGCTGACTATCGAATTGC -> GGCTGACTATCGAATTGCT
CGGCTGTTACGATGTAGCA -> GGCTGTTACGATGTAGCAA
CGGCTTCAGAGACCGATGA -> GGCTTCAGAGACCGATGAC
CGGGAAGCTAGGCGGTCAA -> GGGAAGCTAGGCGGTCAAG
CGGGAGGCCCATGCTCTTT -> GGGAGGCCCATGCTCTTTA
CGGGATTAATCCTACCATA -> GGGATTAATCCTACCATAC
CGGGCGGGGATCGACTTAG -> GGGCGGGGATCGACTTAGT
CGGGCTATCGTATTTTTAC -> GGGCTATCGTATTTTTACA
CGGGGAGGGCCAACCCCGG -> GGGGAGGGCCAACCCCGGT
CGGGGATCGACTTAGTCGG -> GGGGATCGACTTAGTCGGA
CGGGGCACGCGAATTCGCA -> GGGGCACGCGAATTCGCAA
CGGGGGTCTGGTTGTTGGA -> GGGGGTCTGGTTGTTGGAG
CGGGTCCCAGAAGTTACCT -> GGGTCCCAGAAGTTACCTG
CGGGTTCCTAGACCCACGG -> GGGTTCCTAGACCCACGGG
CGGGTTTGAAACGCGGTTG -> GGGTTTGAAACGCGGTTGC
CGGTACAGACGTTTTTGTC -> GGTACAGACGTTTTTGTCG
CGGTAGGTAGAAGTTACCT -> GGTAGGTAGAAGTTACCTG
CGGTCAAGGCGCTTGTCCT -> GGTCAAGGCGCTTGTCCTA
CGGTCCGACATATGAAATT -> GGTCCGACATATGAAATTA
CGGTCTATGTCCGTCGGAA -> GGTCTATGTCCGTCGGAAC
CGGTCTCTCGCGGCTGTTA -> GGTCTCTCGCGGCTGTTAC
CGGTCTTCTGGGAGAAATG -> GGTCTTCTGGGAGAAATGT
CGGTCTTCTTTACACATCG -> GGTCTTCTTTACACATCGT
CGGTGACATTAAAGCCGAG -> GGTGACATTAAAGCCGAGC
CGGTGATACCCTACACCTG -> GGTGATACCCTACACCTGC
CGGTGCCGTCGGGTTTGAA -> GGTGCCGTCGGGTTTGAAA
CGGTGCTCATTTCTGTATG -> GGTGCTCATTTCTGTATGC
CGGTGCTGTAAGGATATTC -> GGTGCTGTAAGGATATTCA
CGGTTATAAACACTCCGGC -> GGTTATAAACACTCCGGCC
CGGTTGCGGAGGATGCGAC -> GGTTGCGGAGGATGCGACT
CGGTTGTCGGCCGAGTGAA -> GGTTGTCGGCCGAGTGAAA
CGGTTTTGCGGCCAACACT -> GGTTTTGCGGCCAACACTA
CGTAACCGCCGTTCCCTAA -> GTAACCGCCGTTCCCTAAT
CGTAATCTAAATTACCTCG -> GTAATCTAAATTACCTCGG
CGTACGTGATCGTTCCTGC -> GTACGTGATCGTTCCTGCC
CGTACTAAAGCGTAACCGC -> GTACTAAAGCGTAACCGCC
CGTAGGCTCACAAATCCCC -> GTAGGCTCACAAATCCCCC
CGTAGTCGTGAATTTGCTG -> GTAGTCGTGAATTTGCTGG
CGTATTAAGGGTCCAGACC -> GTATTAAGGGTCCAGACCC
CGTATTGTCGGCCGAGTGA -> GTATTGTCGGCCGAGTGAA
CGTATTTTTACAGCTATGC -> GTATTTTTACAGCTATGCG
CGTCATTAAAGACGGGCTA -> GTCATTAAAGACGGGCTAT
CGTCCACATCGCCGAAAGT -> GTCCACATCGCCGAAAGTG
CGTCGAAGTTACCTGCGCG -> GTCGAAGTTACCTGCGCGG
CGTCGACCTTCTCTTTGAA -> GTCGACCTTCTCTTTGAAC
CGTCGGAACTAAACGGTGC -> GTCGGAACTAAACGGTGCT
CGTCGGGTTTGAAACGCGG -> GTCGGGTTTGAAACGCGGT
CGTCTAGTAGTGGACATCC -> GTCTAGTAGTGGACATCCT
CGTGAATTTGCTGGATTGA -> GTGAATTTGCTGGATTGAA
CGTGATCGTTCCTGCCGTA -> GTGATCGTTCCTGCCGTAG
CGTGCCACATATTTATAAT -> GTGCCACATATTTATAATT
CGTGCGCATCGTAGGCTCA -> GTGCGCATCGTAGGCTCAC
CGTGGCGGATGGACCCAAA -> GTGGCGGATGGACCCAAAT
CGTGGGGAGTAGTGCTCAG -> GTGGGGAGTAGTGCTCAGC
CGTGTACTTTAGCGGCGCC -> GTGTACTTTAGCGGCGCCT
CGTGTGCTAAACGAACCCT -> GTGTGCTAAACGAACCCTG
CGTGTGTACACTACGCACT -> GTGTGTACACTACGCACTA
CGTGTTCTTGCGCGAGCAC -> GTGTTCTTGCGCGAGCACC
CGTTAAACGGTGCCGTCGG -> GTTAAACGGTGCCGTCGGG
CGTTAAATCTTAGAGTTAC -> GTTAAATCTTAGAGTTACG
CGTTCCCTAATCAAGATAA -> GTTCCCTAATCAAGATAAT
CGTTCCTGCCGTAGTCGTG -> GTTCCTGCCGTAGTCGTGA
CGTTTTTGTCGGCCGAGTG -> GTTTTTGTCGGCCGAGTGA
CTAAACGAACCCTGAACTA -> TAAACGAACCCTGAACTAT
CTAAACGGTGCTCATTTCT -> TAAACGGTGCTCATTTCTG
CTAAAGCGTAACCGCCGTT -> TAAAGCGTAACCGCCGTTC
CTAAATTACCTCGGAAACC -> TAAATTACCTCGGAAACCC
CTAACAAATCATAAGGATG -> TAACAAATCATAAGGATGC
CTAACCGGCACTCCTCTAC -> TAACCGGCACTCCTCTACC
CTAAGACTGCAATTTAGGG -> TAAGACTGCAATTTAGGGG
CTAAGGCACGCCATATACT -> TAAGGCACGCCATATACTA
CTAAGTTGAGACGCCTCAA -> TAAGTTGAGACGCCTCAAA
CTAATAAATTGCGACACCG -> TAATAAATTGCGACACCGG
CTAATAGCTACCAACGGGG -> TAATAGCTACCAACGGGGG
CTAATCAAGATAATATGAG -> TAATCAAGATAATATGAGG
CTACAAGTCACGGCTAATA -> TACAAGTCACGGCTAATAA
CTACACCTGCAGGTGGGCA -> TACACCTGCAGGTGGGCAC
CTACCAACGGGGGTCTGGT -> TACCAACGGGGGTCTGGTT
CTACCATACCGCCAAAACT -> TACCATACCGCCAAAACTA
CTACCTTGACAACGGGGAG -> TACCTTGACAACGGGGAGG
CTACGCACTAAGACTGCAA -> TACGCACTAAGACTGCAAT
CTAGACCCACGGGCGGGGA -> TAGACCCACGGGCGGGGAT
CTAGAGAGAGATATCGCGT -> TAGAGAGAGATATCGCGTG
CTAGAGAGAGTCCAAACTA -> TAGAGAGAGTCCAAACTAG
CTAGCACCTCAATATAAGT -> TAGCACCTCAATATAAGTC
CTAGGCGGTCAAGGCGCTT -> TAGGCGGTCAAGGCGCTTG
CTAGGGCAACTTTGGGAGA -> TAGGGCAACTTTGGGAGAT
CTAGTAGTGGACATCCTAG -> TAGTAGTGGACATCCTAGC
CTATAATGCACTACAAGTC -> TATAATGCACTACAAGTCA
CTATAGGTCGCAGCATTTA -> TATAGGTCGCAGCATTTAA
CTATCAAAGAGGTGGAATG -> TATCAAAGAGGTGGAATGG
CTATCGAATTGCTGGCGTT -> TATCGAATTGCTGGCGTTA
CTATCGTATTTTTACAGCT -> TATCGTATTTTTACAGCTA
CTATGCATTGTGGACGGAC -> TATGCATTGTGGACGGACA
CTATGCCTCGGAAAATCTT -> TATGCCTCGGAAAATCTTG
CTATGCGGGAAGCTAGGCG -> TATGCGGGAAGCTAGGCGG
CTATGGGAATCTCGAGAAG -> TATGGGAATCTCGAGAAGC
CTATGTCCGTCGGAACTAA -> TATGTCCGTCGGAACTAAA
CTATTAATCCATCAATATG -> TATTAATCCATCAATATGC
CTATTAGAAAGCAGACAGC -> TATTAGAAAGCAGACAGCG
CTATTCTGACCCCCAACTG -> TATTCTGACCCCCAACTGC
CTCAAATCTTACACGGACC -> TCAAATCTTACACGGACCA
CTCAAGCTTTGAAAGCCCG -> TCAAGCTTTGAAAGCCCGT
CTCAATATAAGTCTGTAAA -> TCAATATAAGTCTGTAAAT
CTCACAAATCCCCCTTTAA -> TCACAAATCCCCCTTTAAC
CTCAGCATGTTGTCAAATA -> TCAGCATGTTGTCAAATAA
CTCATTTCTGTATGCTCGA -> TCATTTCTGTATGCTCGAT
CTCCAACCGAGATGGTACT -> TCCAACCGAGATGGTACTT
CTCCGAAACCACACTATAG -> TCCGAAACCACACTATAGG
CTCCGGCCGTCTAGTAGTG -> TCCGGCCGTCTAGTAGTGG
CTCCTCTACCTTGACAACG -> TCCTCTACCTTGACAACGG
CTCGAGAAGCGGTACAGAC -> TCGAGAAGCGGTACAGACG
CTCGATGGGCCACACGTCG -> TCGATGGGCCACACGTCGA
CTCGCGGCTGTTACGATGT -> TCGCGGCTGTTACGATGTA
CTCGGAAAAGGAGGCCATG -> TCGGAAAAGGAGGCCATGC
CTCGGAAAATCTTGCGATT -> TCGGAAAATCTTGCGATTA
CTCGGAAACCCAACCCCGC -> TCGGAAACCCAACCCCGCA
CTCGGAGATCGGTTTTGCG -> TCGGAGATCGGTTTTGCGG
CTCGTATTGTCGGCCGAGT -> TCGTATTGTCGGCCGAGTG
CTCTACCTTGACAACGGGG -> TCTACCTTGACAACGGGGA
CTCTATGGGAATCTCGAGA -> TCTATGGGAATCTCGAGAA
CTCTCGCGGCTGTTACGAT -> TCTCGCGGCTGTTACGATG
CTCTTCTACCCGGTCTAGT -> TCTTCTACCCGGTCTAGTC
CTCTTTATAGATGGGGCTA -> TCTTTATAGATGGGGCTAG
CTCTTTGAACCCGCGGGAG -> TCTTTGAACCCGCGGGAGG
CTCTTTTCTCAAGCTTTGA -> TCTTTTCTCAAGCTTTGAA
CTGAACTATAATGCACTAC -> TGAACTATAATGCACTACA
CTGACCCCCAACTGCCGTC -> TGACCCCCAACTGCCGTCC
CTGACCTATTAGAAAGCAG -> TGACCTATTAGAAAGCAGA
CTGACTATCGAATTGCTGG -> TGACTATCGAATTGCTGGC
CTGAGAGAATGAGTGCATC -> TGAGAGAATGAGTGCATCG
CTGAGTACAAGCACGAATC -> TGAGTACAAGCACGAATCT
CTGCAACTGTAATGAAAAG -> TGCAACTGTAATGAAAAGG
CTGCAATTTAGGGGATCTT -> TGCAATTTAGGGGATCTTT
CTGCACTCTTCTACCCGGT -> TGCACTCTTCTACCCGGTC
CTGCAGGTGGGCACGAGCG -> TGCAGGTGGGCACGAGCGT
CTGCCGTAGTCGTGAATTT -> TGCCGTAGTCGTGAATTTG
CTGCCGTCCACATCGCCGA -> TGCCGTCCACATCGCCGAA
CTGCGCGGTCTATGTCCGT -> TGCGCGGTCTATGTCCGTC
CTGCGCGGTCTCTCGCGGC -> TGCGCGGTCTCTCGCGGCT
CTGCGCGGTCTTCTGGGAG -> TGCGCGGTCTTCTGGGAGA
CTGCGCGGTCTTCTTTACA -> TGCGCGGTCTTCTTTACAC
CTGCGCGTGCCACATATTT -> TGCGCGTGCCACATATTTA
CTGCGGTTATAAACACTCC -> TGCGGTTATAAACACTCCG
CTGCTCTTTTCTCAAGCTT -> TGCTCTTTTCTCAAGCTTT
CTGGATTGAAGAACTATCA -> TGGATTGAAGAACTATCAA
CTGGCGTTAAACGGTGCCG -> TGGCGTTAAACGGTGCCGT
CTGGGAGAAATGTAATTAA -> TGGGAGAAATGTAATTAAG
CTGGTCTTCATACTAATAG -> TGGTCTTCATACTAATAGC
CTGGTTCCTCCGAAACCAC -> TGGTTCCTCCGAAACCACA
CTGGTTGTTGGAGTGAGAC -> TGGTTGTTGGAGTGAGACG
CTGTAAATAGTCCCTGTTT -> TGTAAATAGTCCCTGTTTG
CTGTAAGGATATTCATTCG -> TGTAAGGATATTCATTCGG
CTGTAATGAAAAGGCACTC -> TGTAATGAAAAGGCACTCT
CTGTATGCTCGATGGGCCA -> TGTATGCTCGATGGGCCAC
CTGTATTAAACACCCGATT -> TGTATTAAACACCCGATTA
CTGTGCTAAGTTGAGACGC -> TGTGCTAAGTTGAGACGCC
CTGTTACGATGTAGCAACG -> TGTTACGATGTAGCAACGT
CTGTTTGCACTGAGTACAA -> TGTTTGCACTGAGTACAAG
CTTAATATACTTTTATCTG -> TTAATATACTTTTATCTGC
CTTACACGGACCATACGGT -> TTACACGGACCATACGGTG
CTTAGAGTTACGGGTTCCT -> TTAGAGTTACGGGTTCCTA
CTTAGTCGGAATATGGGGG -> TTAGTCGGAATATGGGGGG
CTTCAGAATAGATGATGGT -> TTCAGAATAGATGATGGTG
CTTCAGAGACCGATGACTG -> TTCAGAGACCGATGACTGA
CTTCATACTAATAGCTACC -> TTCATACTAATAGCTACCA
CTTCATGCTGTGCTAAGTT -> TTCATGCTGTGCTAAGTTG
CTTCTCTTTGAACCCGCGG -> TTCTCTTTGAACCCGCGGG
CTTCTGGGAGAAATGTAAT -> TTCTGGGAGAAATGTAATT
CTTCTTTACACATCGTACT -> TTCTTTACACATCGTACTA
CTTGACAACGGGGAGGGCC -> TTGACAACGGGGAGGGCCA
CTTGACACTTCATGCTGTG -> TTGACACTTCATGCTGTGC
CTTGCATAGCGCTTGGAAG -> TTGCATAGCGCTTGGAAGT
CTTGCGATTATCTGCAACT -> TTGCGATTATCTGCAACTG
CTTGCGCGAGCACCTCGGA -> TTGCGCGAGCACCTCGGAG
CTTGGAAGTGGGGACGGAG -> TTGGAAGTGGGGACGGAGA
CTTGGCTGTATTAAACACC -> TTGGCTGTATTAAACACCC
CTTGTCCTATGCATTGTGG -> TTGTCCTATGCATTGTGGA
CTTGTCGGCCGAGTGAAAT -> TTGTCGGCCGAGTGAAATC
CTTTAACGCGCATGCCGAA -> TTTAACGCGCATGCCGAAG
CTTTACACATCGTACTAAA -> TTTACACATCGTACTAAAG
CTTTAGCGGCGCCTATTAA -> TTTAGCGGCGCCTATTAAT
CTTTATAGATGGGGCTAGA -> TTTATAGATGGGGCTAGAG
CTTTCGGAACTGCTCTTTT -> TTTCGGAACTGCTCTTTTC
CTTTGAAAGCCCGTTAAAT -> TTTGAAAGCCCGTTAAATC
CTTTGAACCCGCGGGAGGC -> TTTGAACCCGCGGGAGGCC
CTTTGGGAGATTCGCGGTG -> TTTGGGAGATTCGCGGTGC
CTTTTATCTGCGCGTGCCA -> TTTTATCTGCGCGTGCCAC
CTTTTCTCAAGCTTTGAAA -> TTTTCTCAAGCTTTGAAAG
GAAAAGAGTCCTCCAACCG -> AAAAGAGTCCTCCAACCGA
GAAAAGGAGGCCATGCACG -> AAAAGGAGGCCATGCACGG
GAAAAGGCACTCTATGGGA -> AAAAGGCACTCTATGGGAA
GAAAATCTCGGAAAAGGAG -> AAAATCTCGGAAAAGGAGG
GAAAATCTTGCGATTATCT -> AAAATCTTGCGATTATCTG
GAAACCACACTATAGGTCG -> AAACCACACTATAGGTCGC
GAAACCCAACCCCGCATGT -> AAACCCAACCCCGCATGTA
GAAACGCGGTTGCGGAGGA -> AAACGCGGTTGCGGAGGAT
GAAAGCAGACAGCGTGTGT -> AAAGCAGACAGCGTGTGTA
GAAAGCCCGTTAAATCTTA -> AAAGCCCGTTAAATCTTAG
GAAAGTGGGTACAATCCGC -> AAAGTGGGTACAATCCGCA
GAAATACCAAACCGTCGAA -> AAATACCAAACCGTCGAAG
GAAATCACGGGTCCCAGAA -> AAATCACGGGTCCCAGAAG
GAAATGACGGTAGGTAGAA -> AAATGACGGTAGGTAGAAG
GAAATGTAATTAAGTCCCT -> AAATGTAATTAAGTCCCTG
GAAATTATGTGCGAGCTTG -> AAATTATGTGCGAGCTTGT
GAAATTTGGGATGGGAGAA -> AAATTTGGGATGGGAGAAG
GAACAAAGGAAGAGGTCGG -> AACAAAGGAAGAGGTCGGG
GAACCCGCGGGAGGCCCAT -> AACCCGCGGGAGGCCCATG
GAACCCTGAACTATAATGC -> AACCCTGAACTATAATGCA
GAACTAAACGGTGCTCATT -> AACTAAACGGTGCTCATTT
GAACTATAATGCACTACAA -> AACTATAATGCACTACAAG
GAACTATCAAAGAGGTGGA -> AACTATCAAAGAGGTGGAA
GAACTGCTCTTTTCTCAAG -> AACTGCTCTTTTCTCAAGC
GAAGAACTATCAAAGAGGT -> AAGAACTATCAAAGAGGTG
GAAGAAGGTGTGTCATGTC -> AAGAAGGTGTGTCATGTCC
GAAGAGGTCGGGGCACGCG -> AAGAGGTCGGGGCACGCGA
GAAGCGAATTGCTGACCTA -> AAGCGAATTGCTGACCTAT
GAAGCGGTACAGACGTTTT -> AAGCGGTACAGACGTTTTT
GAAGCTAGGCGGTCAAGGC -> AAGCTAGGCGGTCAAGGCG
GAAGGCGAAGCGAATTGCT -> AAGGCGAAGCGAATTGCTG
GAAGGGTTGAACAAAGGAA -> AAGGGTTGAACAAAGGAAG
GAAGGTGTGTCATGTCCCA -> AAGGTGTGTCATGTCCCAC
GAAGTGGGGACGGAGAATG -> AAGTGGGGACGGAGAATGA
GAAGTTACCTGCGCGGTCT -> AAGTTACCTGCGCGGTCTT,AAGTTACCTGCGCGGTCTA,AAGTTACCTGCGCGGTCTC,AAGTTACCTGCGCGGTCTT
GAATACTTGACACTTCATG -> AATACTTGACACTTCATGC
GAATAGATGATGGTGACAC -> AATAGATGATGGTGACACC
GAATATGGGGGGGGTCAAA -> AATATGGGGGGGGTCAAAT
GAATCTAGAGAGAGATATC -> AATCTAGAGAGAGATATCG
GAATCTCGAGAAGCGGTAC -> AATCTCGAGAAGCGGTACA
GAATGAATACTTGACACTT -> AATGAATACTTGACACTTC
GAATGAGTGCATCGTAATC -> AATGAGTGCATCGTAATCT
GAATGGGTGGTAATTGGCT -> AATGGGTGGTAATTGGCTA
GAATTCGCAAGCTTAATAT -> AATTCGCAAGCTTAATATA
GAATTGCTGACCTATTAGA -> AATTGCTGACCTATTAGAA
GAATTGCTGGCGTTAAACG -> AATTGCTGGCGTTAAACGG
GAATTTGCTGGATTGAAGA -> AATTTGCTGGATTGAAGAA
GACAACGGGGAGGGCCAAC -> ACAACGGGGAGGGCCAACC
GACACCGGCTGACTATCGA -> ACACCGGCTGACTATCGAA
GACACCGGTTGTCGGCCGA -> ACACCGGTTGTCGGCCGAG
GACACTTCATGCTGTGCTA -> ACACTTCATGCTGTGCTAA
GACAGCGTGTGTACACTAC -> ACAGCGTGTGTACACTACG
GACAGGTGGCGACGTGTTC -> ACAGGTGGCGACGTGTTCT
GACATATGAAATTATGTGC -> ACATATGAAATTATGTGCG
GACATCCTAGCACCTCAAT -> ACATCCTAGCACCTCAATA
GACATTAAAGCCGAGCTCG -> ACATTAAAGCCGAGCTCGT
GACCATACGGTGATACCCT -> ACCATACGGTGATACCCTA
GACCCAAATCCAACAACCG -> ACCCAAATCCAACAACCGT
GACCCACGGGCGGGGATCG -> ACCCACGGGCGGGGATCGA
GACCCATGCCCTGCACTCT -> ACCCATGCCCTGCACTCTT
GACCCCCAACTGCCGTCCA -> ACCCCCAACTGCCGTCCAC
GACCCGTGTACTTTAGCGG -> ACCCGTGTACTTTAGCGGC
GACCGATGACTGAGAGAAT -> ACCGATGACTGAGAGAATG
GACCTATTAGAAAGCAGAC -> ACCTATTAGAAAGCAGACA
GACCTTCTCTTTGAACCCG -> ACCTTCTCTTTGAACCCGC
GACGCCTCAAATCTTACAC -> ACGCCTCAAATCTTACACG
GACGGACAGGTGGCGACGT -> ACGGACAGGTGGCGACGTG
GACGGAGAATGAATACTTG -> ACGGAGAATGAATACTTGA
GACGGGCTATCGTATTTTT -> ACGGGCTATCGTATTTTTA
GACGGTAGGTAGAAGTTAC -> ACGGTAGGTAGAAGTTACC
GACGTACGTGATCGTTCCT -> ACGTACGTGATCGTTCCTG
GACGTGTTCTTGCGCGAGC -> ACGTGTTCTTGCGCGAGCA
GACGTTTTTGTCGGCCGAG -> ACGTTTTTGTCGGCCGAGT
GACTATCGAATTGCTGGCG -> ACTATCGAATTGCTGGCGT
GACTGAGAGAATGAGTGCA -> ACTGAGAGAATGAGTGCAT
GACTGCAATTTAGGGGATC -> ACTGCAATTTAGGGGATCT
GACTGGTCTTCATACTAAT -> ACTGGTCTTCATACTAATA
GACTTAGTCGGAATATGGG -> ACTTAGTCGGAATATGGGG
GAGAAATGTAATTAAGTCC -> AGAAATGTAATTAAGTCCC
GAGAAGCGGTACAGACGTT -> AGAAGCGGTACAGACGTTT
GAGAAGTTACCTGCGCGGT -> AGAAGTTACCTGCGCGGTC
GAGAATGAATACTTGACAC -> AGAATGAATACTTGACACT
GAGAATGAGTGCATCGTAA -> AGAATGAGTGCATCGTAAT
GAGACCCGTGTACTTTAGC -> AGACCCGTGTACTTTAGCG
GAGACCGATGACTGAGAGA -> AGACCGATGACTGAGAGAA
GAGACGCCTCAAATCTTAC -> AGACGCCTCAAATCTTACA
GAGACGTACGTGATCGTTC -> AGACGTACGTGATCGTTCC
GAGAGAATGAGTGCATCGT -> AGAGAATGAGTGCATCGTA
GAGAGAGATATCGCGTGGG -> AGAGAGATATCGCGTGGGG
GAGAGAGTCCAAACTAGGG -> AGAGAGTCCAAACTAGGGC
GAGAGATATCGCGTGGGGA -> AGAGATATCGCGTGGGGAG
GAGAGTCCAAACTAGGGCA -> AGAGTCCAAACTAGGGCAA
GAGATATCGCGTGGGGAGT -> AGATATCGCGTGGGGAGTA
GAGATCGGTTTTGCGGCCA -> AGATCGGTTTTGCGGCCAA
GAGATGGTACTTCAGAATA -> AGATGGTACTTCAGAATAG
GAGATTCGCGGTGCTGTAA -> AGATTCGCGGTGCTGTAAG
GAGCACCTCGGAGATCGGT -> AGCACCTCGGAGATCGGTT
GAGCGTCATTAAAGACGGG -> AGCGTCATTAAAGACGGGC
GAGCTCGTATTGTCGGCCG -> AGCTCGTATTGTCGGCCGA
GAGCTTGTCGGCCGAGTGA -> AGCTTGTCGGCCGAGTGAA
GAGGATGCGACTGGTCTTC -> AGGATGCGACTGGTCTTCA
GAGGCCATGCACGGCCACT -> AGGCCATGCACGGCCACTT
GAGGCCCATGCTCTTTATA -> AGGCCCATGCTCTTTATAG
GAGGGCCAACCCCGGTGAC -> AGGGCCAACCCCGGTGACA
GAGGTATGAAGGGTTGAAC -> AGGTATGAAGGGTTGAACA
GAGGTCGATGTGTCCCTTG -> AGGTCGATGTGTCCCTTGC
GAGGTCGGGGCACGCGAAT -> AGGTCGGGGCACGCGAATT
GAGGTGGAATGGGTGGTAA -> AGGTGGAATGGGTGGTAAT
GAGTACAAGCACGAATCTA -> AGTACAAGCACGAATCTAG
GAGTAGTGCTCAGCATGTT -> AGTAGTGCTCAGCATGTTG
GAGTCCAAACTAGGGCAAC -> AGTCCAAACTAGGGCAACT
GAGTCCTCCAACCGAGATG -> AGTCCTCCAACCGAGATGG
GAGTGAAATACCAAACCGT -> AGTGAAATACCAAACCGTC
GAGTGAAATCACGGGTCCC -> AGTGAAATCACGGGTCCCA
GAGTGAAATGACGGTAGGT -> AGTGAAATGACGGTAGGTA
GAGTGAAATTTGGGATGGG -> AGTGAAATTTGGGATGGGA
GAGTGAGACGTACGTGATC -> AGTGAGACGTACGTGATCG
GAGTGCATCGTAATCTAAA -> AGTGCATCGTAATCTAAAT
GAGTTACGGGTTCCTAGAC -> AGTTACGGGTTCCTAGACC
GATAATATGAGGTATGAAG -> ATAATATGAGGTATGAAGG
GATACCCTACACCTGCAGG -> ATACCCTACACCTGCAGGT
GATAGCCGGTCCGACATAT -> ATAGCCGGTCCGACATATG
GATATCGCGTGGGGAGTAG -> ATATCGCGTGGGGAGTAGT
GATATTCATTCGGCTTCAG -> ATATTCATTCGGCTTCAGA
GATCGACTTAGTCGGAATA -> ATCGACTTAGTCGGAATAT
GATCGCCGTATTAAGGGTC -> ATCGCCGTATTAAGGGTCC
GATCGGTTTTGCGGCCAAC -> ATCGGTTTTGCGGCCAACA
GATCGTTCCTGCCGTAGTC -> ATCGTTCCTGCCGTAGTCG
GATCTTTCGGAACTGCTCT -> ATCTTTCGGAACTGCTCTT
GATGACTGAGAGAATGAGT -> ATGACTGAGAGAATGAGTG
GATGATGGTGACACCGGTT -> ATGATGGTGACACCGGTTG
GATGCGACTGGTCTTCATA -> ATGCGACTGGTCTTCATAC
GATGCGATCGCCGTATTAA -> ATGCGATCGCCGTATTAAG
GATGGACCCAAATCCAACA -> ATGGACCCAAATCCAACAA
GATGGGAGAAGTTACCTGC -> ATGGGAGAAGTTACCTGCG
GATGGGCCACACGTCGACC -> ATGGGCCACACGTCGACCT
GATGGGGCTAGAGAGAGTC -> ATGGGGCTAGAGAGAGTCC
GATGGTACTTCAGAATAGA -> ATGGTACTTCAGAATAGAT
GATGGTGACACCGGTTGTC -> ATGGTGACACCGGTTGTCG
GATGTAGCAACGTGTGCTA -> ATGTAGCAACGTGTGCTAA
GATGTGTCCCTTGCATAGC -> ATGTGTCCCTTGCATAGCG
GATTAATCCTACCATACCG -> ATTAATCCTACCATACCGC
GATTATCTGCAACTGTAAT -> ATTATCTGCAACTGTAATG
GATTATTGTGGGTTTAGAG -> ATTATTGTGGGTTTAGAGA
GATTCGCGGTGCTGTAAGG -> ATTCGCGGTGCTGTAAGGA
GATTGAAGAACTATCAAAG -> ATTGAAGAACTATCAAAGA
GCAACGTGTGCTAAACGAA -> CAACGTGTGCTAAACGAAC
GCAACTGTAATGAAAAGGC -> CAACTGTAATGAAAAGGCA
GCAACTTTGGGAGATTCGC -> CAACTTTGGGAGATTCGCG
GCAAGCTTAATATACTTTT -> CAAGCTTAATATACTTTTA
GCAATAGCTAACCGGCACT -> CAATAGCTAACCGGCACTC
GCAATTTAGGGGATCTTTC -> CAATTTAGGGGATCTTTCG
GCACCTCAATATAAGTCTG -> CACCTCAATATAAGTCTGT
GCACCTCGGAGATCGGTTT -> CACCTCGGAGATCGGTTTT
GCACGAATCTAGAGAGAGA -> CACGAATCTAGAGAGAGAT
GCACGAGCGTCATTAAAGA -> CACGAGCGTCATTAAAGAC
GCACGCCATATACTAACAA -> CACGCCATATACTAACAAA
GCACGCGAATTCGCAAGCT -> CACGCGAATTCGCAAGCTT
GCACGGCCACTTGGCTGTA -> CACGGCCACTTGGCTGTAT
GCACTAAGACTGCAATTTA -> CACTAAGACTGCAATTTAG
GCACTACAAGTCACGGCTA -> CACTACAAGTCACGGCTAA
GCACTCCTCTACCTTGACA -> CACTCCTCTACCTTGACAA
GCACTCTATGGGAATCTCG -> CACTCTATGGGAATCTCGA
GCACTCTTCTACCCGGTCT -> CACTCTTCTACCCGGTCTA
GCACTGAGTACAAGCACGA -> CACTGAGTACAAGCACGAA
GCAGAAAAGAGTCCTCCAA -> CAGAAAAGAGTCCTCCAAC
GCAGACAGCGTGTGTACAC -> CAGACAGCGTGTGTACACT
GCAGCATTTAATGAGGTCG -> CAGCATTTAATGAGGTCGA
GCAGGTGGGCACGAGCGTC -> CAGGTGGGCACGAGCGTCA
GCATAGCGCTTGGAAGTGG -> CATAGCGCTTGGAAGTGGG
GCATCGTAATCTAAATTAC -> CATCGTAATCTAAATTACC
GCATCGTAGGCTCACAAAT -> CATCGTAGGCTCACAAATC
GCATGCCGAAGAAGGTGTG -> CATGCCGAAGAAGGTGTGT
GCATGTAGGAAAATCTCGG -> CATGTAGGAAAATCTCGGA
GCATGTTGTCAAATAAATA -> CATGTTGTCAAATAAATAA
GCATTGTGGACGGACAGGT -> CATTGTGGACGGACAGGTG
GCATTTAATGAGGTCGATG -> CATTTAATGAGGTCGATGT
GCCAAAACTAAGGCACGCC -> CCAAAACTAAGGCACGCCA
GCCAACACTATGCCTCGGA -> CCAACACTATGCCTCGGAA
GCCAACCCCGGTGACATTA -> CCAACCCCGGTGACATTAA
GCCACACGTCGACCTTCTC -> CCACACGTCGACCTTCTCT
GCCACATATTTATAATTGG -> CCACATATTTATAATTGGA
GCCACTTGGCTGTATTAAA -> CCACTTGGCTGTATTAAAC
GCCATATACTAACAAATCA -> CCATATACTAACAAATCAT
GCCATGCACGGCCACTTGG -> CCATGCACGGCCACTTGGC
GCCCATGCTCTTTATAGAT -> CCCATGCTCTTTATAGATG
GCCCGTTAAATCTTAGAGT -> CCCGTTAAATCTTAGAGTT
GCCCTGCACTCTTCTACCC -> CCCTGCACTCTTCTACCCG
GCCGAAAGTGGGTACAATC -> CCGAAAGTGGGTACAATCC
GCCGAAGAAGGTGTGTCAT -> CCGAAGAAGGTGTGTCATG
GCCGAGCTCGTATTGTCGG -> CCGAGCTCGTATTGTCGGC
GCCGAGTGAAATACCAAAC -> CCGAGTGAAATACCAAACC
GCCGAGTGAAATCACGGGT -> CCGAGTGAAATCACGGGTC
GCCGAGTGAAATGACGGTA -> CCGAGTGAAATGACGGTAG
GCCGAGTGAAATTTGGGAT -> CCGAGTGAAATTTGGGATG
GCCGGTCCGACATATGAAA -> CCGGTCCGACATATGAAAT
GCCGTAGTCGTGAATTTGC -> CCGTAGTCGTGAATTTGCT
GCCGTATTAAGGGTCCAGA -> CCGTATTAAGGGTCCAGAC
GCCGTCCACATCGCCGAAA -> CCGTCCACATCGCCGAAAG
GCCGTCGGGTTTGAAACGC -> CCGTCGGGTTTGAAACGCG
GCCGTCTAGTAGTGGACAT -> CCGTCTAGTAGTGGACATC
GCCGTGGCGGATGGACCCA -> CCGTGGCGGATGGACCCAA
GCCGTTCCCTAATCAAGAT -> CCGTTCCCTAATCAAGATA
GCCTATTAATCCATCAATA -> CCTATTAATCCATCAATAT
GCCTCAAATCTTACACGGA -> CCTCAAATCTTACACGGAC
GCCTCGGAAAATCTTGCGA -> CCTCGGAAAATCTTGCGAT
GCGAAGCGAATTGCTGACC -> CGAAGCGAATTGCTGACCT
GCGAATTCGCAAGCTTAAT -> CGAATTCGCAAGCTTAATA
GCGAATTGCTGACCTATTA -> CGAATTGCTGACCTATTAG
GCGACACCGGCTGACTATC -> CGACACCGGCTGACTATCG
GCGACGTGTTCTTGCGCGA -> CGACGTGTTCTTGCGCGAG
GCGACTGGTCTTCATACTA -> CGACTGGTCTTCATACTAA
GCGAGCACCTCGGAGATCG -> CGAGCACCTCGGAGATCGG
GCGAGCTTGTCGGCCGAGT -> CGAGCTTGTCGGCCGAGTG
GCGATCGCCGTATTAAGGG -> CGATCGCCGTATTAAGGGT
GCGATTATCTGCAACTGTA -> CGATTATCTGCAACTGTAA
GCGCATCGTAGGCTCACAA -> CGCATCGTAGGCTCACAAA
GCGCATGCCGAAGAAGGTG -> CGCATGCCGAAGAAGGTGT
GCGCCTATTAATCCATCAA -> CGCCTATTAATCCATCAAT
GCGCGAGCACCTCGGAGAT -> CGCGAGCACCTCGGAGATC
GCGCGGTCTATGTCCGTCG -> CGCGGTCTATGTCCGTCGG
GCGCGGTCTCTCGCGGCTG -> CGCGGTCTCTCGCGGCTGT
GCGCGGTCTTCTGGGAGAA -> CGCGGTCTTCTGGGAGAAA
GCGCGGTCTTCTTTACACA -> CGCGGTCTTCTTTACACAT
GCGCGTGCCACATATTTAT -> CGCGTGCCACATATTTATA
GCGCTTGGAAGTGGGGACG -> CGCTTGGAAGTGGGGACGG
GCGCTTGTCCTATGCATTG -> CGCTTGTCCTATGCATTGT
GCGGAGGATGCGACTGGTC -> CGGAGGATGCGACTGGTCT
GCGGATGGACCCAAATCCA -> CGGATGGACCCAAATCCAA
GCGGCCAACACTATGCCTC -> CGGCCAACACTATGCCTCG
GCGGCGCCTATTAATCCAT -> CGGCGCCTATTAATCCATC
GCGGCTGTTACGATGTAGC -> CGGCTGTTACGATGTAGCA
GCGGGAAGCTAGGCGGTCA -> CGGGAAGCTAGGCGGTCAA
GCGGGAGGCCCATGCTCTT -> CGGGAGGCCCATGCTCTTT
GCGGGGATCGACTTAGTCG -> CGGGGATCGACTTAGTCGG
GCGGTACAGACGTTTTTGT -> CGGTACAGACGTTTTTGTC
GCGGTCAAGGCGCTTGTCC -> CGGTCAAGGCGCTTGTCCT
GCGGTCTATGTCCGTCGGA -> CGGTCTATGTCCGTCGGAA
GCGGTCTCTCGCGGCTGTT -> CGGTCTCTCGCGGCTGTTA
GCGGTCTTCTGGGAGAAAT -> CGGTCTTCTGGGAGAAATG
GCGGTCTTCTTTACACATC -> CGGTCTTCTTTACACATCG
GCGGTGCTGTAAGGATATT -> CGGTGCTGTAAGGATATTC
GCGGTTATAAACACTCCGG -> CGGTTATAAACACTCCGGC
GCGGTTGCGGAGGATGCGA -> CGGTTGCGGAGGATGCGAC
GCGTAACCGCCGTTCCCTA -> CGTAACCGCCGTTCCCTAA
GCGTCATTAAAGACGGGCT -> CGTCATTAAAGACGGGCTA
GCGTGCCACATATTTATAA -> CGTGCCACATATTTATAAT
GCGTGGGGAGTAGTGCTCA -> CGTGGGGAGTAGTGCTCAG
GCGTGTGTACACTACGCAC -> CGTGTGTACACTACGCACT
GCGTTAAACGGTGCCGTCG -> CGTTAAACGGTGCCGTCGG
GCTAAACGAACCCTGAACT -> CTAAACGAACCCTGAACTA
GCTAACCGGCACTCCTCTA -> CTAACCGGCACTCCTCTAC
GCTAAGTTGAGACGCCTCA -> CTAAGTTGAGACGCCTCAA
GCTAATAAATTGCGACACC -> CTAATAAATTGCGACACCG
GCTACCAACGGGGGTCTGG -> CTACCAACGGGGGTCTGGT
GCTAGAGAGAGTCCAAACT -> CTAGAGAGAGTCCAAACTA
GCTAGGCGGTCAAGGCGCT -> CTAGGCGGTCAAGGCGCTT
GCTATCGTATTTTTACAGC -> CTATCGTATTTTTACAGCT
GCTATGCGGGAAGCTAGGC -> CTATGCGGGAAGCTAGGCG
GCTATTCTGACCCCCAACT -> CTATTCTGACCCCCAACTG
GCTCACAAATCCCCCTTTA -> CTCACAAATCCCCCTTTAA
GCTCAGCATGTTGTCAAAT -> CTCAGCATGTTGTCAAATA
GCTCATTTCTGTATGCTCG -> CTCATTTCTGTATGCTCGA
GCTCGATGGGCCACACGTC -> CTCGATGGGCCACACGTCG
GCTCGTATTGTCGGCCGAG -> CTCGTATTGTCGGCCGAGT
GCTCTTTATAGATGGGGCT -> CTCTTTATAGATGGGGCTA
GCTCTTTTCTCAAGCTTTG -> CTCTTTTCTCAAGCTTTGA
GCTGACCTATTAGAAAGCA -> CTGACCTATTAGAAAGCAG
GCTGACTATCGAATTGCTG -> CTGACTATCGAATTGCTGG
GCTGGATTGAAGAACTATC -> CTGGATTGAAGAACTATCA
GCTGGCGTTAAACGGTGCC -> CTGGCGTTAAACGGTGCCG
GCTGTAAGGATATTCATTC -> CTGTAAGGATATTCATTCG
GCTGTATTAAACACCCGAT -> CTGTATTAAACACCCGATT
GCTGTGCTAAGTTGAGACG -> CTGTGCTAAGTTGAGACGC
GCTGTTACGATGTAGCAAC -> CTGTTACGATGTAGCAACG
GCTTAATATACTTTTATCT -> CTTAATATACTTTTATCTG
GCTTCAGAGACCGATGACT -> CTTCAGAGACCGATGACTG
GCTTGGAAGTGGGGACGGA -> CTTGGAAGTGGGGACGGAG
GCTTGTCCTATGCATTGTG -> CTTGTCCTATGCATTGTGG
GCTTGTCGGCCGAGTGAAA -> CTTGTCGGCCGAGTGAAAT
GCTTTGAAAGCCCGTTAAA -> CTTTGAAAGCCCGTTAAAT
GGAAAAGGAGGCCATGCAC -> GAAAAGGAGGCCATGCACG
GGAAAATCTCGGAAAAGGA -> GAAAATCTCGGAAAAGGAG
GGAAAATCTTGCGATTATC -> GAAAATCTTGCGATTATCT
GGAAACCCAACCCCGCATG -> GAAACCCAACCCCGCATGT
GGAACTAAACGGTGCTCAT -> GAACTAAACGGTGCTCATT
GGAACTGCTCTTTTCTCAA -> GAACTGCTCTTTTCTCAAG
GGAAGAGGTCGGGGCACGC -> GAAGAGGTCGGGGCACGCG
GGAAGCTAGGCGGTCAAGG -> GAAGCTAGGCGGTCAAGGC
GGAAGGCGAAGCGAATTGC -> GAAGGCGAAGCGAATTGCT
GGAAGTGGGGACGGAGAAT -> GAAGTGGGGACGGAGAATG
GGAATATGGGGGGGGTCAA -> GAATATGGGGGGGGTCAAA
GGAATCTCGAGAAGCGGTA -> GAATCTCGAGAAGCGGTAC
GGAATGGGTGGTAATTGGC -> GAATGGGTGGTAATTGGCT
GGACAGGTGGCGACGTGTT -> GACAGGTGGCGACGTGTTC
GGACATCCTAGCACCTCAA -> GACATCCTAGCACCTCAAT
GGACCATACGGTGATACCC -> GACCATACGGTGATACCCT
GGACCCAAATCCAACAACC -> GACCCAAATCCAACAACCG
GGACGGACAGGTGGCGACG -> GACGGACAGGTGGCGACGT
GGACGGAGAATGAATACTT -> GACGGAGAATGAATACTTG
GGAGAAATGTAATTAAGTC -> GAGAAATGTAATTAAGTCC
GGAGAAGTTACCTGCGCGG -> GAGAAGTTACCTGCGCGGT
GGAGAATGAATACTTGACA -> GAGAATGAATACTTGACAC
GGAGATCGGTTTTGCGGCC -> GAGATCGGTTTTGCGGCCA
GGAGATTCGCGGTGCTGTA -> GAGATTCGCGGTGCTGTAA
GGAGGATGCGACTGGTCTT -> GAGGATGCGACTGGTCTTC
GGAGGCCATGCACGGCCAC -> GAGGCCATGCACGGCCACT
GGAGGCCCATGCTCTTTAT -> GAGGCCCATGCTCTTTATA
GGAGGGCCAACCCCGGTGA -> GAGGGCCAACCCCGGTGAC
GGAGTAGTGCTCAGCATGT -> GAGTAGTGCTCAGCATGTT
GGAGTGAGACGTACGTGAT -> GAGTGAGACGTACGTGATC
GGATATTCATTCGGCTTCA -> GATATTCATTCGGCTTCAG
GGATCGACTTAGTCGGAAT -> GATCGACTTAGTCGGAATA
GGATCTTTCGGAACTGCTC -> GATCTTTCGGAACTGCTCT
GGATGCGACTGGTCTTCAT -> GATGCGACTGGTCTTCATA
GGATGCGATCGCCGTATTA -> GATGCGATCGCCGTATTAA
GGATGGACCCAAATCCAAC -> GATGGACCCAAATCCAACA
GGATGGGAGAAGTTACCTG -> GATGGGAGAAGTTACCTGC
GGATTAATCCTACCATACC -> GATTAATCCTACCATACCG
GGATTGAAGAACTATCAAA -> GATTGAAGAACTATCAAAG
GGCAACTTTGGGAGATTCG -> GCAACTTTGGGAGATTCGC
GGCAATAGCTAACCGGCAC -> GCAATAGCTAACCGGCACT
GGCACGAGCGTCATTAAAG -> GCACGAGCGTCATTAAAGA
GGCACGCCATATACTAACA -> GCACGCCATATACTAACAA
GGCACGCGAATTCGCAAGC -> GCACGCGAATTCGCAAGCT
GGCACTCCTCTACCTTGAC -> GCACTCCTCTACCTTGACA
GGCACTCTATGGGAATCTC -> GCACTCTATGGGAATCTCG
GGCCAACACTATGCCTCGG -> GCCAACACTATGCCTCGGA
GGCCAACCCCGGTGACATT -> GCCAACCCCGGTGACATTA
GGCCACACGTCGACCTTCT -> GCCACACGTCGACCTTCTC
GGCCACTTGGCTGTATTAA -> GCCACTTGGCTGTATTAAA
GGCCATGCACGGCCACTTG -> GCCATGCACGGCCACTTGG
GGCCCATGCTCTTTATAGA -> GCCCATGCTCTTTATAGAT
GGCCGAGTGAAATACCAAA -> GCCGAGTGAAATACCAAAC
GGCCGAGTGAAATCACGGG -> GCCGAGTGAAATCACGGGT
GGCCGAGTGAAATGACGGT -> GCCGAGTGAAATGACGGTA
GGCCGAGTGAAATTTGGGA -> GCCGAGTGAAATTTGGGAT
GGCCGTCTAGTAGTGGACA -> GCCGTCTAGTAGTGGACAT
GGCGAAGCGAATTGCTGAC -> GCGAAGCGAATTGCTGACC
GGCGACGTGTTCTTGCGCG -> GCGACGTGTTCTTGCGCGA
GGCGCCTATTAATCCATCA -> GCGCCTATTAATCCATCAA
GGCGCTTGTCCTATGCATT -> GCGCTTGTCCTATGCATTG
GGCGGATGGACCCAAATCC -> GCGGATGGACCCAAATCCA
GGCGGGGATCGACTTAGTC -> GCGGGGATCGACTTAGTCG
GGCGGTCAAGGCGCTTGTC -> GCGGTCAAGGCGCTTGTCC
GGCGTTAAACGGTGCCGTC -> GCGTTAAACGGTGCCGTCG
GGCTAATAAATTGCGACAC -> GCTAATAAATTGCGACACC
GGCTAGAGAGAGTCCAAAC -> GCTAGAGAGAGTCCAAACT
GGCTATCGTATTTTTACAG -> GCTATCGTATTTTTACAGC
GGCTATTCTGACCCCCAAC -> GCTATTCTGACCCCCAACT
GGCTCACAAATCCCCCTTT -> GCTCACAAATCCCCCTTTA
GGCTGACTATCGAATTGCT -> GCTGACTATCGAATTGCTG
GGCTGTATTAAACACCCGA -> GCTGTATTAAACACCCGAT
GGCTGTTACGATGTAGCAA -> GCTGTTACGATGTAGCAAC
GGCTTCAGAGACCGATGAC -> GCTTCAGAGACCGATGACT
GGGAAGCTAGGCGGTCAAG -> GGAAGCTAGGCGGTCAAGG
GGGAATCTCGAGAAGCGGT -> GGAATCTCGAGAAGCGGTA
GGGACGGAGAATGAATACT -> GGACGGAGAATGAATACTT
GGGAGAAATGTAATTAAGT -> GGAGAAATGTAATTAAGTC
GGGAGAAGTTACCTGCGCG -> GGAGAAGTTACCTGCGCGG
GGGAGATTCGCGGTGCTGT -> GGAGATTCGCGGTGCTGTA
GGGAGGCCCATGCTCTTTA -> GGAGGCCCATGCTCTTTAT
GGGAGGGCCAACCCCGGTG -> GGAGGGCCAACCCCGGTGA
GGGAGTAGTGCTCAGCATG -> GGAGTAGTGCTCAGCATGT
GGGATCGACTTAGTCGGAA -> GGATCGACTTAGTCGGAAT
GGGATCTTTCGGAACTGCT -> GGATCTTTCGGAACTGCTC
GGGATGGGAGAAGTTACCT -> GGATGGGAGAAGTTACCTG
GGGATTAATCCTACCATAC -> GGATTAATCCTACCATACC
GGGCAACTTTGGGAGATTC -> GGCAACTTTGGGAGATTCG
GGGCACGAGCGTCATTAAA -> GGCACGAGCGTCATTAAAG
GGGCACGCGAATTCGCAAG -> GGCACGCGAATTCGCAAGC
GGGCCAACCCCGGTGACAT -> GGCCAACCCCGGTGACATT
GGGCCACACGTCGACCTTC -> GGCCACACGTCGACCTTCT
GGGCGGGGATCGACTTAGT -> GGCGGGGATCGACTTAGTC
GGGCTAGAGAGAGTCCAAA -> GGCTAGAGAGAGTCCAAAC
GGGCTATCGTATTTTTACA -> GGCTATCGTATTTTTACAG
GGGGACGGAGAATGAATAC -> GGGACGGAGAATGAATACT
GGGGAGGGCCAACCCCGGT -> GGGAGGGCCAACCCCGGTG
GGGGAGTAGTGCTCAGCAT -> GGGAGTAGTGCTCAGCATG
GGGGATCGACTTAGTCGGA -> GGGATCGACTTAGTCGGAA
GGGGATCTTTCGGAACTGC -> GGGATCTTTCGGAACTGCT
GGGGCACGCGAATTCGCAA -> GGGCACGCGAATTCGCAAG
GGGGCTAGAGAGAGTCCAA -> GGGCTAGAGAGAGTCCAAA
GGGGGGGGTCAAATAAAAT -> GGGGGGGTCAAATAAAATC
GGGGGGGTCAAATAAAATC -> GGGGGGTCAAATAAAATCG
GGGGGGTCAAATAAAATCG -> GGGGGTCAAATAAAATCGA
GGGGGTCAAATAAAATCGA -> GGGGTCAAATAAAATCGAT
GGGGGTCTGGTTGTTGGAG -> GGGGTCTGGTTGTTGGAGT
GGGGTCAAATAAAATCGAT -> GGGTCAAATAAAATCGATA
GGGGTCTGGTTGTTGGAGT -> GGGTCTGGTTGTTGGAGTG
GGGTACAATCCGCAGAAAA -> GGTACAATCCGCAGAAAAG
GGGTCAAATAAAATCGATA -> GGTCAAATAAAATCGATAG
GGGTCCAGACCCATGCCCT -> GGTCCAGACCCATGCCCTG
GGGTCCCAGAAGTTACCTG -> GGTCCCAGAAGTTACCTGC
GGGTCTGGTTGTTGGAGTG -> GGTCTGGTTGTTGGAGTGA
GGGTGGTAATTGGCTATTC -> GGTGGTAATTGGCTATTCT
GGGTTCCTAGACCCACGGG -> GGTTCCTAGACCCACGGGC
GGGTTGAACAAAGGAAGAG -> GGTTGAACAAAGGAAGAGG
GGGTTTAGAGACCCGTGTA -> GGTTTAGAGACCCGTGTAC
GGGTTTGAAACGCGGTTGC -> GGTTTGAAACGCGGTTGCG
GGTAATTGGCTATTCTGAC -> GTAATTGGCTATTCTGACC
GGTACAATCCGCAGAAAAG -> GTACAATCCGCAGAAAAGA
GGTACAGACGTTTTTGTCG -> GTACAGACGTTTTTGTCGG
GGTACTTCAGAATAGATGA -> GTACTTCAGAATAGATGAT
GGTAGAAGTTACCTGCGCG -> GTAGAAGTTACCTGCGCGG
GGTAGGTAGAAGTTACCTG -> GTAGGTAGAAGTTACCTGC
GGTATGAAGGGTTGAACAA -> GTATGAAGGGTTGAACAAA
GGTCAAATAAAATCGATAG -> GTCAAATAAAATCGATAGC
GGTCAAGGCGCTTGTCCTA -> GTCAAGGCGCTTGTCCTAT
GGTCCAGACCCATGCCCTG -> GTCCAGACCCATGCCCTGC
GGTCCCAGAAGTTACCTGC -> GTCCCAGAAGTTACCTGCG
GGTCCGACATATGAAATTA -> GTCCGACATATGAAATTAT
GGTCGATGTGTCCCTTGCA -> GTCGATGTGTCCCTTGCAT
GGTCGCAGCATTTAATGAG -> GTCGCAGCATTTAATGAGG
GGTCGGGGCACGCGAATTC -> GTCGGGGCACGCGAATTCG
GGTCTATGTCCGTCGGAAC -> GTCTATGTCCGTCGGAACT
GGTCTCTCGCGGCTGTTAC -> GTCTCTCGCGGCTGTTACG
GGTCTGGTTGTTGGAGTGA -> GTCTGGTTGTTGGAGTGAG
GGTCTTCATACTAATAGCT -> GTCTTCATACTAATAGCTA
GGTCTTCTGGGAGAAATGT -> GTCTTCTGGGAGAAATGTA
GGTCTTCTTTACACATCGT -> GTCTTCTTTACACATCGTA
GGTGACACCGGTTGTCGGC -> GTGACACCGGTTGTCGGCC
GGTGACATTAAAGCCGAGC -> GTGACATTAAAGCCGAGCT
GGTGATACCCTACACCTGC -> GTGATACCCTACACCTGCA
GGTGCCGTCGGGTTTGAAA -> GTGCCGTCGGGTTTGAAAC
GGTGCTCATTTCTGTATGC -> GTGCTCATTTCTGTATGCT
GGTGCTGTAAGGATATTCA -> GTGCTGTAAGGATATTCAT
GGTGGAATGGGTGGTAATT -> GTGGAATGGGTGGTAATTG
GGTGGCGACGTGTTCTTGC -> GTGGCGACGTGTTCTTGCG
GGTGGGCACGAGCGTCATT -> GTGGGCACGAGCGTCATTA
GGTGGTAATTGGCTATTCT -> GTGGTAATTGGCTATTCTG
GGTGTGTCATGTCCCACCG -> GTGTGTCATGTCCCACCGG
GGTTATAAACACTCCGGCC -> GTTATAAACACTCCGGCCG
GGTTCCTAGACCCACGGGC -> GTTCCTAGACCCACGGGCG
GGTTCCTCCGAAACCACAC -> GTTCCTCCGAAACCACACT
GGTTGAACAAAGGAAGAGG -> GTTGAACAAAGGAAGAGGT
GGTTGCGGAGGATGCGACT -> GTTGCGGAGGATGCGACTG
GGTTGTCGGCCGAGTGAAA -> GTTGTCGGCCGAGTGAAAT
GGTTGTTGGAGTGAGACGT -> GTTGTTGGAGTGAGACGTA
GGTTTAGAGACCCGTGTAC -> GTTTAGAGACCCGTGTACT
GGTTTGAAACGCGGTTGCG -> GTTTGAAACGCGGTTGCGG
GGTTTTGCGGCCAACACTA -> GTTTTGCGGCCAACACTAT
GTAAATAGTCCCTGTTTGC -> TAAATAGTCCCTGTTTGCA
GTAACCGCCGTTCCCTAAT -> TAACCGCCGTTCCCTAATC
GTAAGGATATTCATTCGGC -> TAAGGATATTCATTCGGCT
GTAATCTAAATTACCTCGG -> TAATCTAAATTACCTCGGA
GTAATGAAAAGGCACTCTA -> TAATGAAAAGGCACTCTAT
GTAATTAAGTCCCTGCGGT -> TAATTAAGTCCCTGCGGTT
GTAATTGGCTATTCTGACC -> TAATTGGCTATTCTGACCC
GTACAAGCACGAATCTAGA -> TACAAGCACGAATCTAGAG
GTACAATCCGCAGAAAAGA -> TACAATCCGCAGAAAAGAG
GTACACTACGCACTAAGAC -> TACACTACGCACTAAGACT
GTACAGACGTTTTTGTCGG -> TACAGACGTTTTTGTCGGC
GTACGTGATCGTTCCTGCC -> TACGTGATCGTTCCTGCCG
GTACTAAAGCGTAACCGCC -> TACTAAAGCGTAACCGCCG
GTACTTCAGAATAGATGAT -> TACTTCAGAATAGATGATG
GTACTTTAGCGGCGCCTAT -> TACTTTAGCGGCGCCTATT
GTAGAAGTTACCTGCGCGG -> TAGAAGTTACCTGCGCGGT
GTAGCAACGTGTGCTAAAC -> TAGCAACGTGTGCTAAACG
GTAGGAAAATCTCGGAAAA -> TAGGAAAATCTCGGAAAAG
GTAGGCTCACAAATCCCCC -> TAGGCTCACAAATCCCCCT
GTAGGTAGAAGTTACCTGC -> TAGGTAGAAGTTACCTGCG
GTAGTCGTGAATTTGCTGG -> TAGTCGTGAATTTGCTGGA
GTAGTGCTCAGCATGTTGT -> TAGTGCTCAGCATGTTGTC
GTAGTGGACATCCTAGCAC -> TAGTGGACATCCTAGCACC
GTATGAAGGGTTGAACAAA -> TATGAAGGGTTGAACAAAG
GTATGCTCGATGGGCCACA -> TATGCTCGATGGGCCACAC
GTATTAAACACCCGATTAT -> TATTAAACACCCGATTATT
GTATTAAGGGTCCAGACCC -> TATTAAGGGTCCAGACCCA
GTATTGTCGGCCGAGTGAA -> TATTGTCGGCCGAGTGAAA
GTATTTTTACAGCTATGCG -> TATTTTTACAGCTATGCGG
GTCAAATAAAATCGATAGC -> TCAAATAAAATCGATAGCC
GTCAAATAAATAATACTGG -> TCAAATAAATAATACTGGT
GTCAAGGCGCTTGTCCTAT -> TCAAGGCGCTTGTCCTATG
GTCACGGCTAATAAATTGC -> TCACGGCTAATAAATTGCG
GTCATGTCCCACCGGGATT -> TCATGTCCCACCGGGATTA
GTCATTAAAGACGGGCTAT -> TCATTAAAGACGGGCTATC
GTCCAAACTAGGGCAACTT -> TCCAAACTAGGGCAACTTT
GTCCACATCGCCGAAAGTG -> TCCACATCGCCGAAAGTGG
GTCCAGACCCATGCCCTGC -> TCCAGACCCATGCCCTGCA
GTCCCACCGGGATTAATCC -> TCCCACCGGGATTAATCCT
GTCCCAGAAGTTACCTGCG -> TCCCAGAAGTTACCTGCGC
GTCCCTGCGGTTATAAACA -> TCCCTGCGGTTATAAACAC
GTCCCTGTTTGCACTGAGT -> TCCCTGTTTGCACTGAGTA
GTCCCTTGCATAGCGCTTG -> TCCCTTGCATAGCGCTTGG
GTCCGACATATGAAATTAT -> TCCGACATATGAAATTATG
GTCCGTCGGAACTAAACGG -> TCCGTCGGAACTAAACGGT
GTCCTATGCATTGTGGACG -> TCCTATGCATTGTGGACGG
GTCCTCCAACCGAGATGGT -> TCCTCCAACCGAGATGGTA
GTCGAAGTTACCTGCGCGG -> TCGAAGTTACCTGCGCGGT
GTCGACCTTCTCTTTGAAC -> TCGACCTTCTCTTTGAACC
GTCGATGTGTCCCTTGCAT -> TCGATGTGTCCCTTGCATA
GTCGCAGCATTTAATGAGG -> TCGCAGCATTTAATGAGGT
GTCGGAACTAAACGGTGCT -> TCGGAACTAAACGGTGCTC
GTCGGAATATGGGGGGGGT -> TCGGAATATGGGGGGGGTC
GTCGGCCGAGTGAAATACC -> TCGGCCGAGTGAAATACCA
GTCGGCCGAGTGAAATCAC -> TCGGCCGAGTGAAATCACG
GTCGGCCGAGTGAAATGAC -> TCGGCCGAGTGAAATGACG
GTCGGCCGAGTGAAATTTG -> TCGGCCGAGTGAAATTTGG
GTCGGGGCACGCGAATTCG -> TCGGGGCACGCGAATTCGC
GTCGGGTTTGAAACGCGGT -> TCGGGTTTGAAACGCGGTT
GTCGTGAATTTGCTGGATT -> TCGTGAATTTGCTGGATTG
GTCTAGTAGTGGACATCCT -> TCTAGTAGTGGACATCCTA
GTCTATGTCCGTCGGAACT -> TCTATGTCCGTCGGAACTA
GTCTCTCGCGGCTGTTACG -> TCTCTCGCGGCTGTTACGA
GTCTGGTTGTTGGAGTGAG -> TCTGGTTGTTGGAGTGAGA
GTCTGTAAATAGTCCCTGT -> TCTGTAAATAGTCCCTGTT
GTCTTCATACTAATAGCTA -> TCTTCATACTAATAGCTAC
GTCTTCTGGGAGAAATGTA -> TCTTCTGGGAGAAATGTAA
GTCTTCTTTACACATCGTA -> TCTTCTTTACACATCGTAC
GTGAAATACCAAACCGTCG -> TGAAATACCAAACCGTCGA
GTGAAATCACGGGTCCCAG -> TGAAATCACGGGTCCCAGA
GTGAAATGACGGTAGGTAG -> TGAAATGACGGTAGGTAGA
GTGAAATTTGGGATGGGAG -> TGAAATTTGGGATGGGAGA
GTGAATTTGCTGGATTGAA -> TGAATTTGCTGGATTGAAG
GTGACACCGGTTGTCGGCC -> TGACACCGGTTGTCGGCCG
GTGACATTAAAGCCGAGCT -> TGACATTAAAGCCGAGCTC
GTGAGACGTACGTGATCGT -> TGAGACGTACGTGATCGTT
GTGATACCCTACACCTGCA -> TGATACCCTACACCTGCAG
GTGATCGTTCCTGCCGTAG -> TGATCGTTCCTGCCGTAGT
GTGCATCGTAATCTAAATT -> TGCATCGTAATCTAAATTA
GTGCCACATATTTATAATT -> TGCCACATATTTATAATTG
GTGCCGTCGGGTTTGAAAC -> TGCCGTCGGGTTTGAAACG
GTGCGAGCTTGTCGGCCGA -> TGCGAGCTTGTCGGCCGAG
GTGCGCATCGTAGGCTCAC -> TGCGCATCGTAGGCTCACA
GTGCTAAACGAACCCTGAA -> TGCTAAACGAACCCTGAAC
GTGCTAAGTTGAGACGCCT -> TGCTAAGTTGAGACGCCTC
GTGCTCAGCATGTTGTCAA -> TGCTCAGCATGTTGTCAAA
GTGCTCATTTCTGTATGCT -> TGCTCATTTCTGTATGCTC
GTGCTGTAAGGATATTCAT -> TGCTGTAAGGATATTCATT
GTGGAATGGGTGGTAATTG -> TGGAATGGGTGGTAATTGG
GTGGACATCCTAGCACCTC -> TGGACATCCTAGCACCTCA
GTGGACGGACAGGTGGCGA -> TGGACGGACAGGTGGCGAC
GTGGCGACGTGTTCTTGCG -> TGGCGACGTGTTCTTGCGC
GTGGCGGATGGACCCAAAT -> TGGCGGATGGACCCAAATC
GTGGGCACGAGCGTCATTA -> TGGGCACGAGCGTCATTAA
GTGGGGACGGAGAATGAAT -> TGGGGACGGAGAATGAATA
GTGGGGAGTAGTGCTCAGC -> TGGGGAGTAGTGCTCAGCA
GTGGGTACAATCCGCAGAA -> TGGGTACAATCCGCAGAAA
GTGGGTTTAGAGACCCGTG -> TGGGTTTAGAGACCCGTGT
GTGGTAATTGGCTATTCTG -> TGGTAATTGGCTATTCTGA
GTGTACACTACGCACTAAG -> TGTACACTACGCACTAAGA
GTGTACTTTAGCGGCGCCT -> TGTACTTTAGCGGCGCCTA
GTGTCATGTCCCACCGGGA -> TGTCATGTCCCACCGGGAT
GTGTCCCTTGCATAGCGCT -> TGTCCCTTGCATAGCGCTT
GTGTGCTAAACGAACCCTG -> TGTGCTAAACGAACCCTGA
GTGTGTACACTACGCACTA -> TGTGTACACTACGCACTAA
GTGTGTCATGTCCCACCGG -> TGTGTCATGTCCCACCGGG
GTGTTCTTGCGCGAGCACC -> TGTTCTTGCGCGAGCACCT
GTTAAACGGTGCCGTCGGG -> TTAAACGGTGCCGTCGGGT
GTTAAATCTTAGAGTTACG -> TTAAATCTTAGAGTTACGG
GTTACCTGCGCGGTCTATG -> TTACCTGCGCGGTCTATGT
GTTACCTGCGCGGTCTCTC -> TTACCTGCGCGGTCTCTCG
GTTACCTGCGCGGTCTTCT -> TTACCTGCGCGGTCTTCTT,TTACCTGCGCGGTCTTCTG
GTTACGATGTAGCAACGTG -> TTACGATGTAGCAACGTGT
GTTACGGGTTCCTAGACCC -> TTACGGGTTCCTAGACCCA
GTTATAAACACTCCGGCCG -> TTATAAACACTCCGGCCGT
GTTCCCTAATCAAGATAAT -> TTCCCTAATCAAGATAATA
GTTCCTAGACCCACGGGCG -> TTCCTAGACCCACGGGCGG
GTTCCTCCGAAACCACACT -> TTCCTCCGAAACCACACTA
GTTCCTGCCGTAGTCGTGA -> TTCCTGCCGTAGTCGTGAA
GTTCTTGCGCGAGCACCTC -> TTCTTGCGCGAGCACCTCG
GTTGAACAAAGGAAGAGGT -> TTGAACAAAGGAAGAGGTC
GTTGAGACGCCTCAAATCT -> TTGAGACGCCTCAAATCTT
GTTGCGGAGGATGCGACTG -> TTGCGGAGGATGCGACTGG
GTTGGAGTGAGACGTACGT -> TTGGAGTGAGACGTACGTG
GTTGTCAAATAAATAATAC -> TTGTCAAATAAATAATACT
GTTGTCGGCCGAGTGAAAT -> TTGTCGGCCGAGTGAAATG
GTTGTTGGAGTGAGACGTA -> TTGTTGGAGTGAGACGTAC
GTTTAGAGACCCGTGTACT -> TTTAGAGACCCGTGTACTT
GTTTGAAACGCGGTTGCGG -> TTTGAAACGCGGTTGCGGA
GTTTGCACTGAGTACAAGC -> TTTGCACTGAGTACAAGCA
GTTTTGCGGCCAACACTAT -> TTTTGCGGCCAACACTATG
GTTTTTGTCGGCCGAGTGA -> TTTTTGTCGGCCGAGTGAA
TAAAATCGATAGCCGGTCC -> AAAATCGATAGCCGGTCCG
TAAACACCCGATTATTGTG -> AAACACCCGATTATTGTGG
TAAACACTCCGGCCGTCTA -> AAACACTCCGGCCGTCTAG
TAAACGAACCCTGAACTAT -> AAACGAACCCTGAACTATA
TAAACGGTGCCGTCGGGTT -> AAACGGTGCCGTCGGGTTT
TAAACGGTGCTCATTTCTG -> AAACGGTGCTCATTTCTGT
TAAAGACGGGCTATCGTAT -> AAAGACGGGCTATCGTATT
TAAAGCCGAGCTCGTATTG -> AAAGCCGAGCTCGTATTGT
TAAAGCGTAACCGCCGTTC -> AAAGCGTAACCGCCGTTCC
TAAATAATACTGGTTCCTC -> AAATAATACTGGTTCCTCC
TAAATAGTCCCTGTTTGCA -> AAATAGTCCCTGTTTGCAC
TAAATCTTAGAGTTACGGG -> AAATCTTAGAGTTACGGGT
TAAATTACCTCGGAAACCC -> AAATTACCTCGGAAACCCA
TAAATTGCGACACCGGCTG -> AAATTGCGACACCGGCTGA
TAACAAATCATAAGGATGC -> AACAAATCATAAGGATGCG
TAACCGCCGTTCCCTAATC -> AACCGCCGTTCCCTAATCA
TAACCGGCACTCCTCTACC -> AACCGGCACTCCTCTACCT
TAACGCGCATGCCGAAGAA -> AACGCGCATGCCGAAGAAG
TAAGACTGCAATTTAGGGG -> AAGACTGCAATTTAGGGGA
TAAGGATATTCATTCGGCT -> AAGGATATTCATTCGGCTT
TAAGGATGCGATCGCCGTA -> AAGGATGCGATCGCCGTAT
TAAGGCACGCCATATACTA -> AAGGCACGCCATATACTAA
TAAGGGTCCAGACCCATGC -> AAGGGTCCAGACCCATGCC
TAAGTCCCTGCGGTTATAA -> AAGTCCCTGCGGTTATAAA
TAAGTCTGTAAATAGTCCC -> AAGTCTGTAAATAGTCCCT
TAAGTTGAGACGCCTCAAA -> AAGTTGAGACGCCTCAAAT
TAATAAATTGCGACACCGG -> AATAAATTGCGACACCGGC
TAATACTGGTTCCTCCGAA -> AATACTGGTTCCTCCGAAA
TAATAGCTACCAACGGGGG -> AATAGCTACCAACGGGGGT
TAATATACTTTTATCTGCG -> AATATACTTTTATCTGCGC
TAATATGAGGTATGAAGGG -> AATATGAGGTATGAAGGGT
TAATCAAGATAATATGAGG -> AATCAAGATAATATGAGGT
TAATCCATCAATATGCCGT -> AATCCATCAATATGCCGTG
TAATCCTACCATACCGCCA -> AATCCTACCATACCGCCAA
TAATCTAAATTACCTCGGA -> AATCTAAATTACCTCGGAA
TAATGAAAAGGCACTCTAT -> AATGAAAAGGCACTCTATG
TAATGAGGTCGATGTGTCC -> AATGAGGTCGATGTGTCCC
TAATGCACTACAAGTCACG -> AATGCACTACAAGTCACGG
TAATTAAGTCCCTGCGGTT -> AATTAAGTCCCTGCGGTTA
TAATTGGAAGGCGAAGCGA -> AATTGGAAGGCGAAGCGAA
TAATTGGCTATTCTGACCC -> AATTGGCTATTCTGACCCC
TACAAGCACGAATCTAGAG -> ACAAGCACGAATCTAGAGA
TACAAGTCACGGCTAATAA -> ACAAGTCACGGCTAATAAA
TACAATCCGCAGAAAAGAG -> ACAATCCGCAGAAAAGAGT
TACACATCGTACTAAAGCG -> ACACATCGTACTAAAGCGT
TACACCTGCAGGTGGGCAC -> ACACCTGCAGGTGGGCACG
TACACGGACCATACGGTGA -> ACACGGACCATACGGTGAT
TACACTACGCACTAAGACT -> ACACTACGCACTAAGACTG
TACAGACGTTTTTGTCGGC -> ACAGACGTTTTTGTCGGCC
TACAGCTATGCGGGAAGCT -> ACAGCTATGCGGGAAGCTA
TACCAAACCGTCGAAGTTA -> ACCAAACCGTCGAAGTTAC
TACCAACGGGGGTCTGGTT -> ACCAACGGGGGTCTGGTTG
TACCATACCGCCAAAACTA -> ACCATACCGCCAAAACTAA
TACCCTACACCTGCAGGTG -> ACCCTACACCTGCAGGTGG
TACCGCCAAAACTAAGGCA -> ACCGCCAAAACTAAGGCAC
TACCTCGGAAACCCAACCC -> ACCTCGGAAACCCAACCCC
TACCTGCGCGGTCTATGTC -> ACCTGCGCGGTCTATGTCC
TACCTGCGCGGTCTCTCGC -> ACCTGCGCGGTCTCTCGCG
TACCTGCGCGGTCTTCTGG -> ACCTGCGCGGTCTTCTGGG
TACCTGCGCGGTCTTCTTT -> ACCTGCGCGGTCTTCTTTA
TACCTTGACAACGGGGAGG -> ACCTTGACAACGGGGAGGG
TACGATGTAGCAACGTGTG -> ACGATGTAGCAACGTGTGC
TACGCACTAAGACTGCAAT -> ACGCACTAAGACTGCAATT
TACGGGTTCCTAGACCCAC -> ACGGGTTCCTAGACCCACG
TACGGTGATACCCTACACC -> ACGGTGATACCCTACACCT
TACGTGATCGTTCCTGCCG -> ACGTGATCGTTCCTGCCGT
TACTAAAGCGTAACCGCCG -> ACTAAAGCGTAACCGCCGT
TACTAACAAATCATAAGGA -> ACTAACAAATCATAAGGAT
TACTAATAGCTACCAACGG -> ACTAATAGCTACCAACGGG
TACTGGTTCCTCCGAAACC -> ACTGGTTCCTCCGAAACCA
TACTTCAGAATAGATGATG -> ACTTCAGAATAGATGATGG
TACTTGACACTTCATGCTG -> ACTTGACACTTCATGCTGT
TACTTTAGCGGCGCCTATT -> ACTTTAGCGGCGCCTATTA
TACTTTTATCTGCGCGTGC -> ACTTTTATCTGCGCGTGCC
TAGAAAGCAGACAGCGTGT -> AGAAAGCAGACAGCGTGTG
TAGAAGTTACCTGCGCGGT -> AGAAGTTACCTGCGCGGTC
TAGACCCACGGGCGGGGAT -> AGACCCACGGGCGGGGATC
TAGAGACCCGTGTACTTTA -> AGAGACCCGTGTACTTTAG
TAGAGAGAGATATCGCGTG -> AGAGAGAGATATCGCGTGG
TAGAGAGAGTCCAAACTAG -> AGAGAGAGTCCAAACTAGG
TAGAGTTACGGGTTCCTAG -> AGAGTTACGGGTTCCTAGA
TAGATGATGGTGACACCGG -> AGATGATGGTGACACCGGT
TAGATGGGGCTAGAGAGAG -> AGATGGGGCTAGAGAGAGT
TAGCAACGTGTGCTAAACG -> AGCAACGTGTGCTAAACGA
TAGCACCTCAATATAAGTC -> AGCACCTCAATATAAGTCT
TAGCCGGTCCGACATATGA -> AGCCGGTCCGACATATGAA
TAGCGCTTGGAAGTGGGGA -> AGCGCTTGGAAGTGGGGAC
TAGCGGCGCCTATTAATCC -> AGCGGCGCCTATTAATCCA
TAGCTAACCGGCACTCCTC -> AGCTAACCGGCACTCCTCT
TAGCTACCAACGGGGGTCT -> AGCTACCAACGGGGGTCTG
TAGGAAAATCTCGGAAAAG -> AGGAAAATCTCGGAAAAGG
TAGGCGGTCAAGGCGCTTG -> AGGCGGTCAAGGCGCTTGT
TAGGCTCACAAATCCCCCT -> AGGCTCACAAATCCCCCTT
TAGGGCAACTTTGGGAGAT -> AGGGCAACTTTGGGAGATT
TAGGGGATCTTTCGGAACT -> AGGGGATCTTTCGGAACTG
TAGGTAGAAGTTACCTGCG -> AGGTAGAAGTTACCTGCGC
TAGGTCGCAGCATTTAATG -> AGGTCGCAGCATTTAATGA
TAGTAGTGGACATCCTAGC -> AGTAGTGGACATCCTAGCA
TAGTCCCTGTTTGCACTGA -> AGTCCCTGTTTGCACTGAG
TAGTCGGAATATGGGGGGG -> AGTCGGAATATGGGGGGGG
TAGTCGTGAATTTGCTGGA -> AGTCGTGAATTTGCTGGAT
TAGTGCTCAGCATGTTGTC -> AGTGCTCAGCATGTTGTCA
TAGTGGACATCCTAGCACC -> AGTGGACATCCTAGCACCT
TATAAACACTCCGGCCGTC -> ATAAACACTCCGGCCGTCT
TATAAGTCTGTAAATAGTC -> ATAAGTCTGTAAATAGTCC
TATAATGCACTACAAGTCA -> ATAATGCACTACAAGTCAC
TATAATTGGAAGGCGAAGC -> ATAATTGGAAGGCGAAGCG
TATACTAACAAATCATAAG -> ATACTAACAAATCATAAGG
TATACTTTTATCTGCGCGT -> ATACTTTTATCTGCGCGTG
TATAGATGGGGCTAGAGAG -> ATAGATGGGGCTAGAGAGA
TATAGGTCGCAGCATTTAA -> ATAGGTCGCAGCATTTAAT
TATCAAAGAGGTGGAATGG -> ATCAAAGAGGTGGAATGGG
TATCGAATTGCTGGCGTTA -> ATCGAATTGCTGGCGTTAA
TATCGCGTGGGGAGTAGTG -> ATCGCGTGGGGAGTAGTGC
TATCGTATTTTTACAGCTA -> ATCGTATTTTTACAGCTAT
TATCTGCAACTGTAATGAA -> ATCTGCAACTGTAATGAAA
TATCTGCGCGTGCCACATA -> ATCTGCGCGTGCCACATAT
TATGAAATTATGTGCGAGC -> ATGAAATTATGTGCGAGCT
TATGAAGGGTTGAACAAAG -> ATGAAGGGTTGAACAAAGG
TATGAGGTATGAAGGGTTG -> ATGAGGTATGAAGGGTTGA
TATGCATTGTGGACGGACA -> ATGCATTGTGGACGGACAG
TATGCCGTGGCGGATGGAC -> ATGCCGTGGCGGATGGACC
TATGCCTCGGAAAATCTTG -> ATGCCTCGGAAAATCTTGC
TATGCGGGAAGCTAGGCGG -> ATGCGGGAAGCTAGGCGGT
TATGCTCGATGGGCCACAC -> ATGCTCGATGGGCCACACG
TATGGGAATCTCGAGAAGC -> ATGGGAATCTCGAGAAGCG
TATGGGGGGGGTCAAATAA -> ATGGGGGGGGTCAAATAAA
TATGTCCGTCGGAACTAAA -> ATGTCCGTCGGAACTAAAC
TATGTGCGAGCTTGTCGGC -> ATGTGCGAGCTTGTCGGCC
TATTAAACACCCGATTATT -> ATTAAACACCCGATTATTG
TATTAAGGGTCCAGACCCA -> ATTAAGGGTCCAGACCCAT
TATTAATCCATCAATATGC -> ATTAATCCATCAATATGCC
TATTAGAAAGCAGACAGCG -> ATTAGAAAGCAGACAGCGT
TATTCATTCGGCTTCAGAG -> ATTCATTCGGCTTCAGAGA
TATTCTGACCCCCAACTGC -> ATTCTGACCCCCAACTGCC
TATTGTCGGCCGAGTGAAA -> ATTGTCGGCCGAGTGAAAT
TATTGTGGGTTTAGAGACC -> ATTGTGGGTTTAGAGACCC
TATTTATAATTGGAAGGCG -> ATTTATAATTGGAAGGCGA
TATTTTTACAGCTATGCGG -> ATTTTTACAGCTATGCGGG
TCAAAGAGGTGGAATGGGT -> CAAAGAGGTGGAATGGGTG
TCAAATAAAATCGATAGCC -> CAAATAAAATCGATAGCCG
TCAAATAAATAATACTGGT -> CAAATAAATAATACTGGTT
TCAAATCTTACACGGACCA -> CAAATCTTACACGGACCAT
TCAAGATAATATGAGGTAT -> CAAGATAATATGAGGTATG
TCAAGCTTTGAAAGCCCGT -> CAAGCTTTGAAAGCCCGTT
TCAAGGCGCTTGTCCTATG -> CAAGGCGCTTGTCCTATGC
TCAATATAAGTCTGTAAAT -> CAATATAAGTCTGTAAATA
TCAATATGCCGTGGCGGAT -> CAATATGCCGTGGCGGATG
TCACAAATCCCCCTTTAAC -> CACAAATCCCCCTTTAACG
TCACGGCTAATAAATTGCG -> CACGGCTAATAAATTGCGA
TCACGGGTCCCAGAAGTTA -> CACGGGTCCCAGAAGTTAC
TCAGAATAGATGATGGTGA -> CAGAATAGATGATGGTGAC
TCAGAGACCGATGACTGAG -> CAGAGACCGATGACTGAGA
TCAGCATGTTGTCAAATAA -> CAGCATGTTGTCAAATAAA
TCATAAGGATGCGATCGCC -> CATAAGGATGCGATCGCCG
TCATACTAATAGCTACCAA -> CATACTAATAGCTACCAAC
TCATGCTGTGCTAAGTTGA -> CATGCTGTGCTAAGTTGAG
TCATGTCCCACCGGGATTA -> CATGTCCCACCGGGATTAA
TCATTAAAGACGGGCTATC -> CATTAAAGACGGGCTATCG
TCATTCGGCTTCAGAGACC -> CATTCGGCTTCAGAGACCG
TCATTTCTGTATGCTCGAT -> CATTTCTGTATGCTCGATG
TCCAAACTAGGGCAACTTT -> CCAAACTAGGGCAACTTTG
TCCAACAACCGTGCGCATC -> CCAACAACCGTGCGCATCG
TCCAACCGAGATGGTACTT -> CCAACCGAGATGGTACTTC
TCCACATCGCCGAAAGTGG -> CCACATCGCCGAAAGTGGG
TCCAGACCCATGCCCTGCA -> CCAGACCCATGCCCTGCAC
TCCATCAATATGCCGTGGC -> CCATCAATATGCCGTGGCG
TCCCACCGGGATTAATCCT -> CCCACCGGGATTAATCCTA
TCCCAGAAGTTACCTGCGC -> CCCAGAAGTTACCTGCGCG
TCCCCCTTTAACGCGCATG -> CCCCCTTTAACGCGCATGC
TCCCTAATCAAGATAATAT -> CCCTAATCAAGATAATATG
TCCCTGCGGTTATAAACAC -> CCCTGCGGTTATAAACACT
TCCCTGTTTGCACTGAGTA -> CCCTGTTTGCACTGAGTAC
TCCCTTGCATAGCGCTTGG -> CCCTTGCATAGCGCTTGGA
TCCGAAACCACACTATAGG -> CCGAAACCACACTATAGGT
TCCGACATATGAAATTATG -> CCGACATATGAAATTATGT
TCCGCAGAAAAGAGTCCTC -> CCGCAGAAAAGAGTCCTCC
TCCGGCCGTCTAGTAGTGG -> CCGGCCGTCTAGTAGTGGA
TCCGTCGGAACTAAACGGT -> CCGTCGGAACTAAACGGTG
TCCTACCATACCGCCAAAA -> CCTACCATACCGCCAAAAC
TCCTAGACCCACGGGCGGG -> CCTAGACCCACGGGCGGGG
TCCTAGCACCTCAATATAA -> CCTAGCACCTCAATATAAG
TCCTATGCATTGTGGACGG -> CCTATGCATTGTGGACGGA
TCCTCCAACCGAGATGGTA -> CCTCCAACCGAGATGGTAC
TCCTCCGAAACCACACTAT -> CCTCCGAAACCACACTATA
TCCTCTACCTTGACAACGG -> CCTCTACCTTGACAACGGG
TCCTGCCGTAGTCGTGAAT -> CCTGCCGTAGTCGTGAATT
TCGAAGTTACCTGCGCGGT -> CGAAGTTACCTGCGCGGTC
TCGAATTGCTGGCGTTAAA -> CGAATTGCTGGCGTTAAAC
TCGACCTTCTCTTTGAACC -> CGACCTTCTCTTTGAACCC
TCGACTTAGTCGGAATATG -> CGACTTAGTCGGAATATGG
TCGAGAAGCGGTACAGACG -> CGAGAAGCGGTACAGACGT
TCGATAGCCGGTCCGACAT -> CGATAGCCGGTCCGACATA
TCGATGGGCCACACGTCGA -> CGATGGGCCACACGTCGAC
TCGATGTGTCCCTTGCATA -> CGATGTGTCCCTTGCATAG
TCGCAAGCTTAATATACTT -> CGCAAGCTTAATATACTTT
TCGCAGCATTTAATGAGGT -> CGCAGCATTTAATGAGGTC
TCGCCGAAAGTGGGTACAA -> CGCCGAAAGTGGGTACAAT
TCGCCGTATTAAGGGTCCA -> CGCCGTATTAAGGGTCCAG
TCGCGGCTGTTACGATGTA -> CGCGGCTGTTACGATGTAG
TCGCGGTGCTGTAAGGATA -> CGCGGTGCTGTAAGGATAT
TCGCGTGGGGAGTAGTGCT -> CGCGTGGGGAGTAGTGCTC
TCGGAAAAGGAGGCCATGC -> CGGAAAAGGAGGCCATGCA
TCGGAAAATCTTGCGATTA -> CGGAAAATCTTGCGATTAT
TCGGAAACCCAACCCCGCA -> CGGAAACCCAACCCCGCAT
TCGGAACTAAACGGTGCTC -> CGGAACTAAACGGTGCTCA
TCGGAACTGCTCTTTTCTC -> CGGAACTGCTCTTTTCTCA
TCGGAATATGGGGGGGGTC -> CGGAATATGGGGGGGGTCA
TCGGAGATCGGTTTTGCGG -> CGGAGATCGGTTTTGCGGC
TCGGCCGAGTGAAATACCA -> CGGCCGAGTGAAATACCAA
TCGGCCGAGTGAAATCACG -> CGGCCGAGTGAAATCACGG
TCGGCCGAGTGAAATGACG -> CGGCCGAGTGAAATGACGG
TCGGCCGAGTGAAATTTGG -> CGGCCGAGTGAAATTTGGG
TCGGCTTCAGAGACCGATG -> CGGCTTCAGAGACCGATGA
TCGGGGCACGCGAATTCGC -> CGGGGCACGCGAATTCGCA
TCGGGTTTGAAACGCGGTT -> CGGGTTTGAAACGCGGTTG
TCGGTTTTGCGGCCAACAC -> CGGTTTTGCGGCCAACACT
TCGTAATCTAAATTACCTC -> CGTAATCTAAATTACCTCG
TCGTACTAAAGCGTAACCG -> CGTACTAAAGCGTAACCGC
TCGTAGGCTCACAAATCCC -> CGTAGGCTCACAAATCCCC
TCGTATTGTCGGCCGAGTG -> CGTATTGTCGGCCGAGTGA
TCGTATTTTTACAGCTATG -> CGTATTTTTACAGCTATGC
TCGTGAATTTGCTGGATTG -> CGTGAATTTGCTGGATTGA
TCGTTCCTGCCGTAGTCGT -> CGTTCCTGCCGTAGTCGTG
TCTAAATTACCTCGGAAAC -> CTAAATTACCTCGGAAACC
TCTACCTTGACAACGGGGA -> CTACCTTGACAACGGGGAG
TCTAGAGAGAGATATCGCG -> CTAGAGAGAGATATCGCGT
TCTAGTAGTGGACATCCTA -> CTAGTAGTGGACATCCTAG
TCTATGGGAATCTCGAGAA -> CTATGGGAATCTCGAGAAG
TCTATGTCCGTCGGAACTA -> CTATGTCCGTCGGAACTAA
TCTCAAGCTTTGAAAGCCC -> CTCAAGCTTTGAAAGCCCG
TCTCGAGAAGCGGTACAGA -> CTCGAGAAGCGGTACAGAC
TCTCGCGGCTGTTACGATG -> CTCGCGGCTGTTACGATGT
TCTCGGAAAAGGAGGCCAT -> CTCGGAAAAGGAGGCCATG
TCTCTCGCGGCTGTTACGA -> CTCTCGCGGCTGTTACGAT
TCTCTTTGAACCCGCGGGA -> CTCTTTGAACCCGCGGGAG
TCTGACCCCCAACTGCCGT -> CTGACCCCCAACTGCCGTC
TCTGCAACTGTAATGAAAA -> CTGCAACTGTAATGAAAAG
TCTGCGCGTGCCACATATT -> CTGCGCGTGCCACATATTT
TCTGGGAGAAATGTAATTA -> CTGGGAGAAATGTAATTAA
TCTGGTTGTTGGAGTGAGA -> CTGGTTGTTGGAGTGAGAC
TCTGTAAATAGTCCCTGTT -> CTGTAAATAGTCCCTGTTT
TCTGTATGCTCGATGGGCC -> CTGTATGCTCGATGGGCCA
TCTTACACGGACCATACGG -> CTTACACGGACCATACGGT
TCTTAGAGTTACGGGTTCC -> CTTAGAGTTACGGGTTCCT
TCTTCATACTAATAGCTAC -> CTTCATACTAATAGCTACC
TCTTCTACCCGGTCTAGTC -> CTTCTACCCGGTCTAGTCT
TCTTCTGGGAGAAATGTAA -> CTTCTGGGAGAAATGTAAT
TCTTCTTTACACATCGTAC -> CTTCTTTACACATCGTACT
TCTTGCGATTATCTGCAAC -> CTTGCGATTATCTGCAACT
TCTTGCGCGAGCACCTCGG -> CTTGCGCGAGCACCTCGGA
TCTTTACACATCGTACTAA -> CTTTACACATCGTACTAAA
TCTTTATAGATGGGGCTAG -> CTTTATAGATGGGGCTAGA
TCTTTCGGAACTGCTCTTT -> CTTTCGGAACTGCTCTTTT
TCTTTGAACCCGCGGGAGG -> CTTTGAACCCGCGGGAGGC
TCTTTTCTCAAGCTTTGAA -> CTTTTCTCAAGCTTTGAAA
TGAAAAGGCACTCTATGGG -> GAAAAGGCACTCTATGGGA
TGAAACGCGGTTGCGGAGG -> GAAACGCGGTTGCGGAGGA
TGAAAGCCCGTTAAATCTT -> GAAAGCCCGTTAAATCTTA
TGAAATACCAAACCGTCGA -> GAAATACCAAACCGTCGAA
TGAAATCACGGGTCCCAGA -> GAAATCACGGGTCCCAGAA
TGAAATGACGGTAGGTAGA -> GAAATGACGGTAGGTAGAA
TGAAATTATGTGCGAGCTT -> GAAATTATGTGCGAGCTTG
TGAAATTTGGGATGGGAGA -> GAAATTTGGGATGGGAGAA
TGAACAAAGGAAGAGGTCG -> GAACAAAGGAAGAGGTCGG
TGAACCCGCGGGAGGCCCA -> GAACCCGCGGGAGGCCCAT
TGAACTATAATGCACTACA -> GAACTATAATGCACTACAA
TGAAGAACTATCAAAGAGG -> GAAGAACTATCAAAGAGGT
TGAAGGGTTGAACAAAGGA -> GAAGGGTTGAACAAAGGAA
TGAATACTTGACACTTCAT -> GAATACTTGACACTTCATG
TGAATTTGCTGGATTGAAG -> GAATTTGCTGGATTGAAGA
TGACAACGGGGAGGGCCAA -> GACAACGGGGAGGGCCAAC
TGACACCGGTTGTCGGCCG -> GACACCGGTTGTCGGCCGA
TGACACTTCATGCTGTGCT -> GACACTTCATGCTGTGCTA
TGACATTAAAGCCGAGCTC -> GACATTAAAGCCGAGCTCG
TGACCCCCAACTGCCGTCC -> GACCCCCAACTGCCGTCCA
TGACCTATTAGAAAGCAGA -> GACCTATTAGAAAGCAGAC
TGACGGTAGGTAGAAGTTA -> GACGGTAGGTAGAAGTTAC
TGACTATCGAATTGCTGGC -> GACTATCGAATTGCTGGCG
TGACTGAGAGAATGAGTGC -> GACTGAGAGAATGAGTGCA
TGAGACGCCTCAAATCTTA -> GAGACGCCTCAAATCTTAC
TGAGACGTACGTGATCGTT -> GAGACGTACGTGATCGTTC
TGAGAGAATGAGTGCATCG -> GAGAGAATGAGTGCATCGT
TGAGGTATGAAGGGTTGAA -> GAGGTATGAAGGGTTGAAC
TGAGGTCGATGTGTCCCTT -> GAGGTCGATGTGTCCCTTG
TGAGTACAAGCACGAATCT -> GAGTACAAGCACGAATCTA
TGAGTGCATCGTAATCTAA -> GAGTGCATCGTAATCTAAA
TGATACCCTACACCTGCAG -> GATACCCTACACCTGCAGG
TGATCGTTCCTGCCGTAGT -> GATCGTTCCTGCCGTAGTC
TGATGGTGACACCGGTTGT -> GATGGTGACACCGGTTGTC
TGCAACTGTAATGAAAAGG -> GCAACTGTAATGAAAAGGC
TGCAATTTAGGGGATCTTT -> GCAATTTAGGGGATCTTTC
TGCACGGCCACTTGGCTGT -> GCACGGCCACTTGGCTGTA
TGCACTACAAGTCACGGCT -> GCACTACAAGTCACGGCTA
TGCACTCTTCTACCCGGTC -> GCACTCTTCTACCCGGTCT
TGCACTGAGTACAAGCACG -> GCACTGAGTACAAGCACGA
TGCAGGTGGGCACGAGCGT -> GCAGGTGGGCACGAGCGTC
TGCATAGCGCTTGGAAGTG -> GCATAGCGCTTGGAAGTGG
TGCATCGTAATCTAAATTA -> GCATCGTAATCTAAATTAC
TGCATTGTGGACGGACAGG -> GCATTGTGGACGGACAGGT
TGCCACATATTTATAATTG -> GCCACATATTTATAATTGG
TGCCCTGCACTCTTCTACC -> GCCCTGCACTCTTCTACCC
TGCCGAAGAAGGTGTGTCA -> GCCGAAGAAGGTGTGTCAT
TGCCGTAGTCGTGAATTTG -> GCCGTAGTCGTGAATTTGC
TGCCGTCCACATCGCCGAA -> GCCGTCCACATCGCCGAAA
TGCCGTCGGGTTTGAAACG -> GCCGTCGGGTTTGAAACGC
TGCCGTGGCGGATGGACCC -> GCCGTGGCGGATGGACCCA
TGCCTCGGAAAATCTTGCG -> GCCTCGGAAAATCTTGCGA
TGCGACACCGGCTGACTAT -> GCGACACCGGCTGACTATC
TGCGACTGGTCTTCATACT -> GCGACTGGTCTTCATACTA
TGCGAGCTTGTCGGCCGAG -> GCGAGCTTGTCGGCCGAGT
TGCGATCGCCGTATTAAGG -> GCGATCGCCGTATTAAGGG
TGCGATTATCTGCAACTGT -> GCGATTATCTGCAACTGTA
TGCGCATCGTAGGCTCACA -> GCGCATCGTAGGCTCACAA
TGCGCGAGCACCTCGGAGA -> GCGCGAGCACCTCGGAGAT
TGCGCGGTCTATGTCCGTC -> GCGCGGTCTATGTCCGTCG
TGCGCGGTCTCTCGCGGCT -> GCGCGGTCTCTCGCGGCTG
TGCGCGGTCTTCTGGGAGA -> GCGCGGTCTTCTGGGAGAA
TGCGCGGTCTTCTTTACAC -> GCGCGGTCTTCTTTACACA
TGCGCGTGCCACATATTTA -> GCGCGTGCCACATATTTAT
TGCGGAGGATGCGACTGGT -> GCGGAGGATGCGACTGGTC
TGCGGCCAACACTATGCCT -> GCGGCCAACACTATGCCTC
TGCGGGAAGCTAGGCGGTC -> GCGGGAAGCTAGGCGGTCA
TGCGGTTATAAACACTCCG -> GCGGTTATAAACACTCCGG
TGCTAAACGAACCCTGAAC -> GCTAAACGAACCCTGAACT
TGCTAAGTTGAGACGCCTC -> GCTAAGTTGAGACGCCTCA
TGCTCAGCATGTTGTCAAA -> GCTCAGCATGTTGTCAAAT
TGCTCATTTCTGTATGCTC -> GCTCATTTCTGTATGCTCG
TGCTCGATGGGCCACACGT -> GCTCGATGGGCCACACGTC
TGCTCTTTATAGATGGGGC -> GCTCTTTATAGATGGGGCT
TGCTCTTTTCTCAAGCTTT -> GCTCTTTTCTCAAGCTTTG
TGCTGACCTATTAGAAAGC -> GCTGACCTATTAGAAAGCA
TGCTGGATTGAAGAACTAT -> GCTGGATTGAAGAACTATC
TGCTGGCGTTAAACGGTGC -> GCTGGCGTTAAACGGTGCC
TGCTGTAAGGATATTCATT -> GCTGTAAGGATATTCATTC
TGCTGTGCTAAGTTGAGAC -> GCTGTGCTAAGTTGAGACG
TGGAAGGCGAAGCGAATTG -> GGAAGGCGAAGCGAATTGC
TGGAAGTGGGGACGGAGAA -> GGAAGTGGGGACGGAGAAT
TGGAATGGGTGGTAATTGG -> GGAATGGGTGGTAATTGGC
TGGACATCCTAGCACCTCA -> GGACATCCTAGCACCTCAA
TGGACCCAAATCCAACAAC -> GGACCCAAATCCAACAACC
TGGACGGACAGGTGGCGAC -> GGACGGACAGGTGGCGACG
TGGAGTGAGACGTACGTGA -> GGAGTGAGACGTACGTGAT
TGGATTGAAGAACTATCAA -> GGATTGAAGAACTATCAAA
TGGCAATAGCTAACCGGCA -> GGCAATAGCTAACCGGCAC
TGGCGACGTGTTCTTGCGC -> GGCGACGTGTTCTTGCGCG
TGGCGGATGGACCCAAATC -> GGCGGATGGACCCAAATCC
TGGCGTTAAACGGTGCCGT -> GGCGTTAAACGGTGCCGTC
TGGCTATTCTGACCCCCAA -> GGCTATTCTGACCCCCAAC
TGGCTGTATTAAACACCCG -> GGCTGTATTAAACACCCGA
TGGGAATCTCGAGAAGCGG -> GGGAATCTCGAGAAGCGGT
TGGGAGAAATGTAATTAAG -> GGGAGAAATGTAATTAAGT
TGGGAGAAGTTACCTGCGC -> GGGAGAAGTTACCTGCGCG
TGGGAGATTCGCGGTGCTG -> GGGAGATTCGCGGTGCTGT
TGGGATGGGAGAAGTTACC -> GGGATGGGAGAAGTTACCT
TGGGCACGAGCGTCATTAA -> GGGCACGAGCGTCATTAAA
TGGGCCACACGTCGACCTT -> GGGCCACACGTCGACCTTC
TGGGGACGGAGAATGAATA -> GGGGACGGAGAATGAATAC
TGGGGAGTAGTGCTCAGCA -> GGGGAGTAGTGCTCAGCAT
TGGGGCTAGAGAGAGTCCA -> GGGGCTAGAGAGAGTCCAA
TGGGGGGGGTCAAATAAAA -> GGGGGGGGTCAAATAAAAT
TGGGTACAATCCGCAGAAA -> GGGTACAATCCGCAGAAAA
TGGGTGGTAATTGGCTATT -> GGGTGGTAATTGGCTATTC
TGGGTTTAGAGACCCGTGT -> GGGTTTAGAGACCCGTGTA
TGGTAATTGGCTATTCTGA -> GGTAATTGGCTATTCTGAC
TGGTACTTCAGAATAGATG -> GGTACTTCAGAATAGATGA
TGGTCTTCATACTAATAGC -> GGTCTTCATACTAATAGCT
TGGTGACACCGGTTGTCGG -> GGTGACACCGGTTGTCGGC
TGGTTCCTCCGAAACCACA -> GGTTCCTCCGAAACCACAC
TGGTTGTTGGAGTGAGACG -> GGTTGTTGGAGTGAGACGT
TGTAAATAGTCCCTGTTTG -> GTAAATAGTCCCTGTTTGC
TGTAAGGATATTCATTCGG -> GTAAGGATATTCATTCGGC
TGTAATGAAAAGGCACTCT -> GTAATGAAAAGGCACTCTA
TGTAATTAAGTCCCTGCGG -> GTAATTAAGTCCCTGCGGT
TGTACACTACGCACTAAGA -> GTACACTACGCACTAAGAC
TGTACTTTAGCGGCGCCTA -> GTACTTTAGCGGCGCCTAT
TGTAGCAACGTGTGCTAAA -> GTAGCAACGTGTGCTAAAC
TGTAGGAAAATCTCGGAAA -> GTAGGAAAATCTCGGAAAA
TGTATGCTCGATGGGCCAC -> GTATGCTCGATGGGCCACA
TGTATTAAACACCCGATTA -> GTATTAAACACCCGATTAT
TGTCAAATAAATAATACTG -> GTCAAATAAATAATACTGG
TGTCATGTCCCACCGGGAT -> GTCATGTCCCACCGGGATT
TGTCCCACCGGGATTAATC -> GTCCCACCGGGATTAATCC
TGTCCCTTGCATAGCGCTT -> GTCCCTTGCATAGCGCTTG
TGTCCGTCGGAACTAAACG -> GTCCGTCGGAACTAAACGG
TGTCCTATGCATTGTGGAC -> GTCCTATGCATTGTGGACG
TGTCGGCCGAGTGAAATAC -> GTCGGCCGAGTGAAATACC
TGTCGGCCGAGTGAAATCA -> GTCGGCCGAGTGAAATCAC
TGTCGGCCGAGTGAAATGA -> GTCGGCCGAGTGAAATGAC
TGTCGGCCGAGTGAAATTT -> GTCGGCCGAGTGAAATTTG
TGTGCGAGCTTGTCGGCCG -> GTGCGAGCTTGTCGGCCGA
TGTGCTAAACGAACCCTGA -> GTGCTAAACGAACCCTGAA
TGTGCTAAGTTGAGACGCC -> GTGCTAAGTTGAGACGCCT
TGTGGACGGACAGGTGGCG -> GTGGACGGACAGGTGGCGA
TGTGGGTTTAGAGACCCGT -> GTGGGTTTAGAGACCCGTG
TGTGTACACTACGCACTAA -> GTGTACACTACGCACTAAG
TGTGTCATGTCCCACCGGG -> GTGTCATGTCCCACCGGGA
TGTGTCCCTTGCATAGCGC -> GTGTCCCTTGCATAGCGCT
TGTTACGATGTAGCAACGT -> GTTACGATGTAGCAACGTG
TGTTCTTGCGCGAGCACCT -> GTTCTTGCGCGAGCACCTC
TGTTGGAGTGAGACGTACG -> GTTGGAGTGAGACGTACGT
TGTTGTCAAATAAATAATA -> GTTGTCAAATAAATAATAC
TGTTTGCACTGAGTACAAG -> GTTTGCACTGAGTACAAGC
TTAAACACCCGATTATTGT -> TAAACACCCGATTATTGTG
TTAAACGGTGCCGTCGGGT -> TAAACGGTGCCGTCGGGTT
TTAAAGACGGGCTATCGTA -> TAAAGACGGGCTATCGTAT
TTAAAGCCGAGCTCGTATT -> TAAAGCCGAGCTCGTATTG
TTAAATCTTAGAGTTACGG -> TAAATCTTAGAGTTACGGG
TTAACGCGCATGCCGAAGA -> TAACGCGCATGCCGAAGAA
TTAAGGGTCCAGACCCATG -> TAAGGGTCCAGACCCATGC
TTAAGTCCCTGCGGTTATA -> TAAGTCCCTGCGGTTATAA
TTAATATACTTTTATCTGC -> TAATATACTTTTATCTGCG
TTAATCCATCAATATGCCG -> TAATCCATCAATATGCCGT
TTAATCCTACCATACCGCC -> TAATCCTACCATACCGCCA
TTAATGAGGTCGATGTGTC -> TAATGAGGTCGATGTGTCC
TTACACATCGTACTAAAGC -> TACACATCGTACTAAAGCG
TTACACGGACCATACGGTG -> TACACGGACCATACGGTGA
TTACAGCTATGCGGGAAGC -> TACAGCTATGCGGGAAGCT
TTACCTCGGAAACCCAACC -> TACCTCGGAAACCCAACCC
TTACCTGCGCGGTCTATGT -> TACCTGCGCGGTCTATGTC
TTACCTGCGCGGTCTCTCG -> TACCTGCGCGGTCTCTCGC
TTACCTGCGCGGTCTTCTG -> TACCTGCGCGGTCTTCTGG
TTACCTGCGCGGTCTTCTT -> TACCTGCGCGGTCTTCTTT
TTACGATGTAGCAACGTGT -> TACGATGTAGCAACGTGTG
TTACGGGTTCCTAGACCCA -> TACGGGTTCCTAGACCCAC
TTAGAAAGCAGACAGCGTG -> TAGAAAGCAGACAGCGTGT
TTAGAGACCCGTGTACTTT -> TAGAGACCCGTGTACTTTA
TTAGAGTTACGGGTTCCTA -> TAGAGTTACGGGTTCCTAG
TTAGCGGCGCCTATTAATC -> TAGCGGCGCCTATTAATCC
TTAGGGGATCTTTCGGAAC -> TAGGGGATCTTTCGGAACT
TTAGTCGGAATATGGGGGG -> TAGTCGGAATATGGGGGGG
TTATAAACACTCCGGCCGT -> TATAAACACTCCGGCCGTC
TTATAATTGGAAGGCGAAG -> TATAATTGGAAGGCGAAGC
TTATAGATGGGGCTAGAGA -> TATAGATGGGGCTAGAGAG
TTATCTGCAACTGTAATGA -> TATCTGCAACTGTAATGAA
TTATCTGCGCGTGCCACAT -> TATCTGCGCGTGCCACATA
TTATGTGCGAGCTTGTCGG -> TATGTGCGAGCTTGTCGGC
TTATTGTGGGTTTAGAGAC -> TATTGTGGGTTTAGAGACC
TTCAGAATAGATGATGGTG -> TCAGAATAGATGATGGTGA
TTCAGAGACCGATGACTGA -> TCAGAGACCGATGACTGAG
TTCATACTAATAGCTACCA -> TCATACTAATAGCTACCAA
TTCATGCTGTGCTAAGTTG -> TCATGCTGTGCTAAGTTGA
TTCATTCGGCTTCAGAGAC -> TCATTCGGCTTCAGAGACC
TTCCCTAATCAAGATAATA -> TCCCTAATCAAGATAATAT
TTCCTAGACCCACGGGCGG -> TCCTAGACCCACGGGCGGG
TTCCTCCGAAACCACACTA -> TCCTCCGAAACCACACTAT
TTCCTGCCGTAGTCGTGAA -> TCCTGCCGTAGTCGTGAAT
TTCGCAAGCTTAATATACT -> TCGCAAGCTTAATATACTT
TTCGCGGTGCTGTAAGGAT -> TCGCGGTGCTGTAAGGATA
TTCGGAACTGCTCTTTTCT -> TCGGAACTGCTCTTTTCTC
TTCGGCTTCAGAGACCGAT -> TCGGCTTCAGAGACCGATG
TTCTCAAGCTTTGAAAGCC -> TCTCAAGCTTTGAAAGCCC
TTCTCTTTGAACCCGCGGG -> TCTCTTTGAACCCGCGGGA
TTCTGACCCCCAACTGCCG -> TCTGACCCCCAACTGCCGT
TTCTGGGAGAAATGTAATT -> TCTGGGAGAAATGTAATTA
TTCTGTATGCTCGATGGGC -> TCTGTATGCTCGATGGGCC
TTCTTGCGCGAGCACCTCG -> TCTTGCGCGAGCACCTCGG
TTCTTTACACATCGTACTA -> TCTTTACACATCGTACTAA
TTGAAACGCGGTTGCGGAG -> TGAAACGCGGTTGCGGAGG
TTGAAAGCCCGTTAAATCT -> TGAAAGCCCGTTAAATCTT
TTGAACAAAGGAAGAGGTC -> TGAACAAAGGAAGAGGTCG
TTGAACCCGCGGGAGGCCC -> TGAACCCGCGGGAGGCCCA
TTGAAGAACTATCAAAGAG -> TGAAGAACTATCAAAGAGG
TTGACAACGGGGAGGGCCA -> TGACAACGGGGAGGGCCAA
TTGACACTTCATGCTGTGC -> TGACACTTCATGCTGTGCT
TTGAGACGCCTCAAATCTT -> TGAGACGCCTCAAATCTTA
TTGCACTGAGTACAAGCAC -> TGCACTGAGTACAAGCACG
TTGCATAGCGCTTGGAAGT -> TGCATAGCGCTTGGAAGTG
TTGCGACACCGGCTGACTA -> TGCGACACCGGCTGACTAT
TTGCGATTATCTGCAACTG -> TGCGATTATCTGCAACTGT
TTGCGCGAGCACCTCGGAG -> TGCGCGAGCACCTCGGAGA
TTGCGGAGGATGCGACTGG -> TGCGGAGGATGCGACTGGT
TTGCGGCCAACACTATGCC -> TGCGGCCAACACTATGCCT
TTGCTGACCTATTAGAAAG -> TGCTGACCTATTAGAAAGC
TTGCTGGATTGAAGAACTA -> TGCTGGATTGAAGAACTAT
TTGCTGGCGTTAAACGGTG -> TGCTGGCGTTAAACGGTGC
TTGGAAGGCGAAGCGAATT -> TGGAAGGCGAAGCGAATTG
TTGGAAGTGGGGACGGAGA -> TGGAAGTGGGGACGGAGAA
TTGGAGTGAGACGTACGTG -> TGGAGTGAGACGTACGTGA
TTGGCTATTCTGACCCCCA -> TGGCTATTCTGACCCCCAA
TTGGCTGTATTAAACACCC -> TGGCTGTATTAAACACCCG
TTGGGAGATTCGCGGTGCT -> TGGGAGATTCGCGGTGCTG
TTGGGATGGGAGAAGTTAC -> TGGGATGGGAGAAGTTACC
TTGTCAAATAAATAATACT -> TGTCAAATAAATAATACTG
TTGTCCTATGCATTGTGGA -> TGTCCTATGCATTGTGGAC
TTGTCGGCCGAGTGAAATA -> TGTCGGCCGAGTGAAATAC
TTGTCGGCCGAGTGAAATC -> TGTCGGCCGAGTGAAATCA
TTGTCGGCCGAGTGAAATG -> TGTCGGCCGAGTGAAATGA
TTGTCGGCCGAGTGAAATT -> TGTCGGCCGAGTGAAATTT
TTGTGGACGGACAGGTGGC -> TGTGGACGGACAGGTGGCG
TTGTGGGTTTAGAGACCCG -> TGTGGGTTTAGAGACCCGT
TTGTTGGAGTGAGACGTAC -> TGTTGGAGTGAGACGTACG
TTTAACGCGCATGCCGAAG -> TTAACGCGCATGCCGAAGA
TTTAATGAGGTCGATGTGT -> TTAATGAGGTCGATGTGTC
TTTACACATCGTACTAAAG -> TTACACATCGTACTAAAGC
TTTACAGCTATGCGGGAAG -> TTACAGCTATGCGGGAAGC
TTTAGAGACCCGTGTACTT -> TTAGAGACCCGTGTACTTT
TTTAGCGGCGCCTATTAAT -> TTAGCGGCGCCTATTAATC
TTTAGGGGATCTTTCGGAA -> TTAGGGGATCTTTCGGAAC
TTTATAATTGGAAGGCGAA -> TTATAATTGGAAGGCGAAG
TTTATAGATGGGGCTAGAG -> TTATAGATGGGGCTAGAGA
TTTATCTGCGCGTGCCACA -> TTATCTGCGCGTGCCACAT
TTTCGGAACTGCTCTTTTC -> TTCGGAACTGCTCTTTTCT
TTTCTCAAGCTTTGAAAGC -> TTCTCAAGCTTTGAAAGCC
TTTCTGTATGCTCGATGGG -> TTCTGTATGCTCGATGGGC
TTTGAAACGCGGTTGCGGA -> TTGAAACGCGGTTGCGGAG
TTTGAAAGCCCGTTAAATC -> TTGAAAGCCCGTTAAATCT
TTTGAACCCGCGGGAGGCC -> TTGAACCCGCGGGAGGCCC
TTTGCACTGAGTACAAGCA -> TTGCACTGAGTACAAGCAC
TTTGCGGCCAACACTATGC -> TTGCGGCCAACACTATGCC
TTTGCTGGATTGAAGAACT -> TTGCTGGATTGAAGAACTA
TTTGGGAGATTCGCGGTGC -> TTGGGAGATTCGCGGTGCT
TTTGGGATGGGAGAAGTTA -> TTGGGATGGGAGAAGTTAC
TTTGTCGGCCGAGTGAAAT -> TTGTCGGCCGAGTGAAATT
TTTTACAGCTATGCGGGAA -> TTTACAGCTATGCGGGAAG
TTTTATCTGCGCGTGCCAC -> TTTATCTGCGCGTGCCACA
TTTTCTCAAGCTTTGAAAG -> TTTCTCAAGCTTTGAAAGC
TTTTGCGGCCAACACTATG -> TTTGCGGCCAACACTATGC
TTTTGTCGGCCGAGTGAAA -> TTTGTCGGCCGAGTGAAAT
TTTTTACAGCTATGCGGGA -> TTTTACAGCTATGCGGGAA
TTTTTGTCGGCCGAGTGAA -> TTTTGTCGGCCGAGTGAAA
