30 100
TAGAGGGACCGCAGGGACGGTAGGCGTCCC|CTGGTACACCACCGTCCAGGTCCTAAGATA
GTCGCAGGTATCCTTACTACGCGTACCCGA|GTATGGGGACTAGTCCAGGTCCTAAGATAG
TGATACTACCAGTCCAGGTCCTAAGATAGA|TAGAGGGACCGCAGGGTCTCCTTTTCATCC
ATTAGAGCGATAGGCTTAAGAGCCGTCTGT|TCCAGGTCCTAAGATAGAGGGACCGCAGGA
AGGGACCGCAGGCGTGGGTACTACGGAGCA|CAGAAAATGGTCCAGGTCCTAAGATAGAGG
GCAGGCCCCTGTGTTCCCGTACGTGTGGTC|TCCAGGTCCTAAGATAGAGGGACCGCAGGG
GGACCGCAGGCGTAGTCGAGCATGTTCCCC|AGACGCATACCGCCGCATATGGCCACGCCC
TCCTAGCTCATCAGCAAGATTCGTGACAAA|TCCGTGGGGTCGTACCCTATTGCCAGTCAA
TATAGGTCCTACAGAAAATGGTCCAGGTCC|TAAGATAGAGGGACCGCAGGCTATGTGGGC
TTTAAGCCTACCAACGTGCAGCGCGGCTTC|GTCCAGGTCCTAAGATAGAGGGACCGCAGG
CCTATTGCCAGTCAATATATTCTGGGCCTG|GCAAGCCGTAAGCCTACTATGTTAATACTC
GGTCCTAAGATAGAGGGACCGCAGGCGGCA|TCTCCTTTTCATCCATGGTCAATGGACTAG
TACGCATAGACGCATACCGCCGCATATGGC|GGGACCGCAGGCGGCACGGTCGCAGGTATC
AGGTCCTAAGATAGAGGGACCGCAGGCCTT|CCGCAGGCGTAGTCGAGCATGTTCCCCCAA
CACCGTCCAGGTCCTAAGATAGAGGGACCG|TGCGATAAAGATGAGACTACGCATAGACGC
CCTGTGTTCCCGTACGTGTGGTCCAGGTCC|CCTAAGATAGAGGGACCGCAGGGACGGTAG
GCCTTTCCCACGCTCAGGGACTTTAAGCCT|AGAGGGACCGCAGGGAGGGACGTCCAGGTC
TTAAGAGCCGTCTGTTGGTGATACTACCAG|AGAGGGACCGCAGGAAGATAGAGGGACCGC
AGTCCAGGTCCTAAGATAGAGGGACCGCAG|GCGTGTAAGGACACTGCGCCAAGTACATAT
TCTCCCCCGCAGGCCCCTGTGTTCCCGTAC|ATTTAAAGTCCAGGTCCTAAGATAGAGGGA
TCTGATGCTTCATTTCAGAGGGCCGTATTT|ACTAAAGTCCAGGTCCTAAGATAGAGGGAC
AACAGATCTCCCCCGCAGGCCCCTGTGTTC|GGCCGTATTTAAAGTCCAGGTCCTAAGATA
GAAGTGAACAGATCTCCCCCGCAGGCCCCT|TCAGAGGGCCGTATTTAAAGTCCAGGTCCT
CTGGGCCTGCGCGGACGCGTGTAAGGACAC|TTAATACTCTACATTCGTCGCATATCTCTA
CCGTGGGGTCGTACCCTATTGCCAGTCAAT|GTGGGTACTACGGAGCAAGCCGTAAGCCTA
TCCAGGTCCTAAGATAGAGGGACCGCAGGC|TAAAGATGAGACTACGCATAGACGCATACC
AGGTCCTAAGATAGAGGGACCGCAGGGAGG|TAAGGACACTGCGCCAAGTACATATGCTGC
AGGGACCGCAGGGACGGTAGGCGTCCCCGG|GTACACCACCGTCCAGGTCCTAAGATAGAG
GCGAGAGCCCTCCTGGGCCTCAGGCGCGGG|AGAAACGGATAGCGATTGTACTAGTCCAGG
GGGTATGGGGACTAGTCCAGGTCCTAAGAT|TCCTAGCTCATCAGCAAGATTCGTGACAAA
TACACGCTCGAAGCTGATTCATTGACACTC|TTCGGTGGTGTTCCTAATCAAAGGATTAGA
TGCAGCGCGGCTTCTGGCACTATATCCTAG|AGAGGGACCGCAGGCGCAGGGTGATCCGTG
GTCCAGGTCCTAAGATAGAGGGACCGCAGG|CGTGTAAGGACACTGCGCCAAGTACATATG
ACAGAACTAAAGTCCAGGTCCTAAGATAGA|CGAAGCTGATTCATTGACACTCTGAAAAGA
GGTCCTAAGATAGAGGGACCGCAGGATGAT|TGGGCCAGGCTCGCTTCCGTCCACGTACTG
TCGCATATCTCTACTCAACAAGCGAGAGCC|TTCCGCAAATAAATCGGCAGGAGAAACGGA
TTCAGAATTCTGGGTCGTATTTCTTTAATT|GACCGCAGGCCTTTCTACTAAACCACAGAA
CCTAAGATAGTCCAGGTCCTAAGATAGAGG|GCGCGGACGCGTGTAAGGACACTGCGCCAA
CGCGGACGCGTGTAAGGACACTGCGCCAAG|TACATTCGTCGCATATCTCTACTCAACAAG
AGGTTAAACAAGGGTCTGGTACACCACCGT|CTCCCCCTAGGTTGCTAGCACAAGTGCGAT
CCTAAGATAGAGGGACCGCAGGCGTAGTCG|GAGACTACGCATAGACGCATACCGCCGCAT
AGAATTCTGGGTCGTATTTCTTTAATTCTG|CGCAGGCCTTTCTACTAAACCACAGAACTA
TCATTTCAGAGGGCCGTATTTAAAGTCCAG|CAGGTCCTAAGATAGAGGGACCGCAGGTTA
CGTCCAGGTCCTAAGATAGAGGGACCGCAG|ACCAATCGGACGTCCAGGTCCTAAGATAGA
AGGTCCTAAGATAGAGGGACCGCAGGGACG|TAAACAAGGGTCTGGTACACCACCGTCCAG
TTGACACTCTGAAAAGAGCGACGCACTCCC|AGGATTAGAGCGATAGGCTTAAGAGCCGTC
CCGCAGGCGCAGGGTGATCCGTGGGGTCGT|GATAGAGGGACCGCAGGCGTGGGTACTACG
GCAGGTTAAACAAGGGTCTGGTACACCACC|CACTCCCCCTAGGTTGCTAGCACAAGTGCG
CCAGGTCCTAAGATAGAGGGACCGCAGGAG|AGATTCGTGACAAAGTCGGAGTCCAGGTCC
GTGTGGTCCAGGTCCTAAGATAGAGGGACC|CCGCAGGGACGGTAGGCGTCCCCGGTCCAG
TCTTTAATTCTGATGCTTCATTTCAGAGGG|ACCACAGAACTAAAGTCCAGGTCCTAAGAT
CTACGGAGCAAGCCGTAAGCCTACTATGTT|AAGATAGAGGGACCGCAGGATGATTAGCAC
GCTGCTTACCAATCGGACGTCCAGGTCCTA|CCTCCTGGGCCTCAGGCGCGGGGCTTATAG
TAGGCGTCCCCGGTCCAGGTCCTAAGATAG|TCCTAAGATAGAGGGACCGCAGGCGTAGTC
TTAAAGTCCAGGTCCTAAGATAGAGGGACC|ACCGCAGGTTAAACAAGGGTCTGGTACACC
CTGCGCCAAGTACATATGCTGCTTACCAAT|ACTCAACAAGCGAGAGCCCTCCTGGGCCTC
GAGCAAGCCGTAAGCCTACTATGTTAATAC|AGAGGGACCGCAGGATGATTAGCACGCACC
CGCATATGGCCACGCCCCAAGGATTCGGTG|CGCAGGTATCCTTACTACGCGTACCCGACC
TACCAGTCCAGGTCCTAAGATAGAGGGACC|GACCGCAGGGTCTCCTTTTCATCCATGGTC
CTAAGATAGAGGGACCGCAGGGACGGTAGG|AAGGGTCTGGTACACCACCGTCCAGGTCCT
AGGCCTTTCTACTAAACCACAGAACTAAAG|CCCCCAACGGTACACGCTCGAAGCTGATTC
CTACTATGTTAATACTCTACATTCGTCGCA|TGATTAGCACGCACCCCAGGCTTGTTTCCG
GACCGCAGGCGTAGTCGAGCATGTTCCCCC|GACGCATACCGCCGCATATGGCCACGCCCC
AAGATTCGTGACAAAGTCGGAGTCCAGGTC|CCTATTGCCAGTCAATATATTCTGGGCCTG
CCAGGTCCTAAGATAGAGGGACCGCAGGCC|GACCGCAGGCGTAGTCGAGCATGTTCCCCC
GCAGGAAGATAGAGGGACCGCAGGGTCTCC|CCCACGCTCAGGGACTTTAAGCCTACCAAC
GCCCCTGTGTTCCCGTACGTGTGGTCCAGG|GGTCCTAAGATAGAGGGACCGCAGGGACGG
CAGGTCCTAAGATAGTCCAGGTCCTAAGAT|GGCCTGCGCGGACGCGTGTAAGGACACTGC
TTAGAGCGATAGGCTTAAGAGCCGTCTGTT|CCAGGTCCTAAGATAGAGGGACCGCAGGAA
GATAGAGGGACCGCAGGGACGGTAGGCGTC|GTCTGGTACACCACCGTCCAGGTCCTAAGA
GGGGACTAGTCCAGGTCCTAAGATAGAGGG|CTCATCAGCAAGATTCGTGACAAAGTCGGA
TGATTCATTGACACTCTGAAAAGAGCGACG|TAATCAAAGGATTAGAGCGATAGGCTTAAG
CATATGGCCACGCCCCAAGGATTCGGTGGT|CAGGTATCCTTACTACGCGTACCCGACCAC
TTCTACTAAACCACAGAACTAAAGTCCAGG|ACGGTACACGCTCGAAGCTGATTCATTGAC
GCAGGCGTAGTCGAGCATGTTCCCCCAACG|CATACCGCCGCATATGGCCACGCCCCAAGG
CCCTCCTGGGCCTCAGGCGCGGGGCTTATA|GATAGCGATTGTACTAGTCCAGGTCCTAAG
ATATCCTAGCTCATCAGCAAGATTCGTGAC|TGATCCGTGGGGTCGTACCCTATTGCCAGT
TTAGCACGCACCCCAGGCTTGTTTCCGCAA|GCAGATTCTTCATTGTATGATCATCCGGGC
GTCCTAAGATAGAGGGACCGCAGGCCCTGT|GTAGGCGTCCCCGGTCCAGGTCCTAAGATA
TGGACTAGGGGTATGGGGACTAGTCCAGGT|GCACTATATCCTAGCTCATCAGCAAGATTC
TGATCCGTGGGGTCGTACCCTATTGCCAGT|AGGCGTGGGTACTACGGAGCAAGCCGTAAG
GATAGAGGGACCGCAGGTTAAACAAGGGTC|AAAAGAGCGACGCACTCCCCCTAGGTTGCT
TGTTGTGTTCAGAATTCTGGGTCGTATTTC|ATAGAGGGACCGCAGGCCTTTCTACTAAAC
GTCTGTTGGTGATACTACCAGTCCAGGTCC|GCAGGAAGATAGAGGGACCGCAGGGTCTCC
TAAGATAGAGGGACCGCAGGAGACGCACAA|GACAAAGTCGGAGTCCAGGTCCTAAGATAG
AGATGAGACTACGCATAGACGCATACCGCC|TAAGATAGAGGGACCGCAGGCGGCACGGTC
CGGTCCAGGTCCTAAGATAGAGGGACCGCA|GAGGGACCGCAGGCGTAGTCGAGCATGTTC
ATGATTAGCACGCACCCCAGGCTTGTTTCC|TACTGCAGATTCTTCATTGTATGATCATCC
CCACGCCCCAAGGATTCGGTGGTGTTCCTA|CCTTACTACGCGTACCCGACCACTAAGTCC
GTACATATGCTGCTTACCAATCGGACGTCC|GCGAGAGCCCTCCTGGGCCTCAGGCGCGGG
TAGTCGAGCATGTTCCCCCAACGGTACACG|CCGCATATGGCCACGCCCCAAGGATTCGGT
GTGGGTACTACGGAGCAAGCCGTAAGCCTA|AGGTCCTAAGATAGAGGGACCGCAGGATGA
CTATATCCTAGCTCATCAGCAAGATTCGTG|GGTGATCCGTGGGGTCGTACCCTATTGCCA
AATGGTCCAGGTCCTAAGATAGAGGGACCG|CAGGCTATGTGGGCCAGGCTCGCTTCCGTC
CTGGCACTATATCCTAGCTCATCAGCAAGA|GCGCAGGGTGATCCGTGGGGTCGTACCCTA
GTTAAACAAGGGTCTGGTACACCACCGTCC|CCCCCTAGGTTGCTAGCACAAGTGCGATAA
ATGGACTAGGGGTATGGGGACTAGTCCAGG|GGCACTATATCCTAGCTCATCAGCAAGATT
CCTTTCCCACGCTCAGGGACTTTAAGCCTA|GAGGGACCGCAGGGAGGGACGTCCAGGTCC
AGGACACTGCGCCAAGTACATATGCTGCTT|ATCTCTACTCAACAAGCGAGAGCCCTCCTG
GATAGAGGGACCGCAGGGAGGGACGTCCAG|TGCGCCAAGTACATATGCTGCTTACCAATC
ATTAGCACGCACCCCAGGCTTGTTTCCGCA|TGCAGATTCTTCATTGTATGATCATCCGGG
CGCAGGAAGATAGAGGGACCGCAGGGTCTC|TCCCACGCTCAGGGACTTTAAGCCTACCAA
GCCTACTATGTTAATACTCTACATTCGTCG|GATGATTAGCACGCACCCCAGGCTTGTTTC
TCCCCGGTCCAGGTCCTAAGATAGAGGGAC|GATAGAGGGACCGCAGGCGTAGTCGAGCAT
GGCCGTATTTAAAGTCCAGGTCCTAAGATA|ATAGAGGGACCGCAGGTTAAACAAGGGTCT
GCACCCCAGGCTTGTTTCCGCAAATAAATC|CTTCATTGTATGATCATCCGGGCGGTCGAC
GTCCAGGTCCTAAGATAGAGGGACCGCAGG|CATTGACACTCTGAAAAGAGCGACGCACTC
ACTAAACCACAGAACTAAAGTCCAGGTCCT|TACACGCTCGAAGCTGATTCATTGACACTC
TCCAGGTCCTAAGATAGAGGGACCGCAGGC|GGGGCTTATAGGTCCTACAGAAAATGGTCC
ACCGCAGGAGACGCACAACGATACAAATTC|GTCCAGGTCCTAAGATAGTCCAGGTCCTAA
ACACGCTCGAAGCTGATTCATTGACACTCT|TCGGTGGTGTTCCTAATCAAAGGATTAGAG
AGGCTTAAGAGCCGTCTGTTGGTGATACTA|AGATAGAGGGACCGCAGGAAGATAGAGGGA
CGCGGGGCTTATAGGTCCTACAGAAAATGG|TCCAGGTCCTAAGATAGAGGGACCGCAGGC
CGTATTTCTTTAATTCTGATGCTTCATTTC|TACTAAACCACAGAACTAAAGTCCAGGTCC
TCCAGGTCCTAAGATAGAGGGACCGCAGGG|GGTTAAACAAGGGTCTGGTACACCACCGTC
TCGGTGGTGTTCCTAATCAAAGGATTAGAG|CCGACCACTAAGTCCAGGTCCTGTCCAGGT
GGTCCTGTCCAGGTCCTAAGATAGAGGGAC|AGACGCACAACGATACAAATTCCCTGCCTT
GCAGGCCTTTCTACTAAACCACAGAACTAA|TTCCCCCAACGGTACACGCTCGAAGCTGAT
GCCGTCTGTTGGTGATACTACCAGTCCAGG|ACCGCAGGAAGATAGAGGGACCGCAGGGTC
TCAGGCGCGGGGCTTATAGGTCCTACAGAA|ACTAGTCCAGGTCCTAAGATAGAGGGACCG
GACGCGTGTAAGGACACTGCGCCAAGTACA|TTCGTCGCATATCTCTACTCAACAAGCGAG
GGTCCTAAGATAGAGGGACCGCAGGAGACG|TTCGTGACAAAGTCGGAGTCCAGGTCCTAA
GCCGCATATGGCCACGCCCCAAGGATTCGG|GTCGCAGGTATCCTTACTACGCGTACCCGA
ACCGCAGGGTCTCCTTTTCATCCATGGTCA|TTAAGCCTACCAACGTGCAGCGCGGCTTCT
GGGCCTGCGCGGACGCGTGTAAGGACACTG|AATACTCTACATTCGTCGCATATCTCTACT
CACGGTCGCAGGTATCCTTACTACGCGTAC|AGGGGTATGGGGACTAGTCCAGGTCCTAAG
AAGTGAACAGATCTCCCCCGCAGGCCCCTG|CAGAGGGCCGTATTTAAAGTCCAGGTCCTA
CAATCGGACGTCCAGGTCCTAAGATAGAGG|CCTCAGGCGCGGGGCTTATAGGTCCTACAG
TTTCAGAGGGCCGTATTTAAAGTCCAGGTC|GTCCTAAGATAGAGGGACCGCAGGTTAAAC
ACCGCAGGCCCTGTTGTGTTCAGAATTCTG|CAGGTCCTAAGATAGAGGGACCGCAGGCCT
CCAGGTCCTAAGATAGAGGGACCGCAGGCG|AAAGATGAGACTACGCATAGACGCATACCG
GGACGTCCAGGTCCTAAGATAGAGGGACCG|GGCGCGGGGCTTATAGGTCCTACAGAAAAT
GGACACTGCGCCAAGTACATATGCTGCTTA|TCTCTACTCAACAAGCGAGAGCCCTCCTGG
CTGAAAAGAGCGACGCACTCCCCCTAGGTT|AGCGATAGGCTTAAGAGCCGTCTGTTGGTG
TGCTGCTTACCAATCGGACGTCCAGGTCCT|CCCTCCTGGGCCTCAGGCGCGGGGCTTATA
AAGATAGAGGGACCGCAGGCGCAGGGTGAT|TCCAGGTCCTAAGATAGAGGGACCGCAGGC
AAGCCTACTATGTTAATACTCTACATTCGT|AGGATGATTAGCACGCACCCCAGGCTTGTT
CGGAGTCCAGGTCCTAAGATAGTCCAGGTC|TATTCTGGGCCTGCGCGGACGCGTGTAAGG
GTGTAAGGACACTGCGCCAAGTACATATGC|CGCATATCTCTACTCAACAAGCGAGAGCCC
TAATACTCTACATTCGTCGCATATCTCTAC|CGCACCCCAGGCTTGTTTCCGCAAATAAAT
ATAGAGGGACCGCAGGCGTGGGTACTACGG|CCTACAGAAAATGGTCCAGGTCCTAAGATA
TTCTGGGTCGTATTTCTTTAATTCTGATGC|GGCCTTTCTACTAAACCACAGAACTAAAGT
CATGTTCCCCCAACGGTACACGCTCGAAGC|GGCCACGCCCCAAGGATTCGGTGGTGTTCC
GGTCCTAAGATAGAGGGACCGCAGGCGTGG|CTTATAGGTCCTACAGAAAATGGTCCAGGT
TAGAGGGACCGCAGGAGACGCACAACGATA|AGTCGGAGTCCAGGTCCTAAGATAGTCCAG
GTTGCTAGCACAAGTGCGATAAAGATGAGA|GTGATACTACCAGTCCAGGTCCTAAGATAG
CGGTAGGCGTCCCCGGTCCAGGTCCTAAGA|AGGTCCTAAGATAGAGGGACCGCAGGCGTA
GACACTGCGCCAAGTACATATGCTGCTTAC|CTCTACTCAACAAGCGAGAGCCCTCCTGGG
TCCTAAGATAGAGGGACCGCAGGCCCTGTT|TAGGCGTCCCCGGTCCAGGTCCTAAGATAG
TAGAGGGACCGCAGGCGCAGGGTGATCCGT|GGTCCTAAGATAGAGGGACCGCAGGCGTGG
TAGCTCATCAGCAAGATTCGTGACAAAGTC|GTGGGGTCGTACCCTATTGCCAGTCAATAT
AGGCGCGGGGCTTATAGGTCCTACAGAAAA|TAGTCCAGGTCCTAAGATAGAGGGACCGCA
GTGTTCCCGTACGTGTGGTCCAGGTCCTAA|AAGATAGAGGGACCGCAGGGACGGTAGGCG
CAGGGTGATCCGTGGGGTCGTACCCTATTG|ACCGCAGGCGTGGGTACTACGGAGCAAGCC
CGCACAACGATACAAATTCCCTGCCTTTCC|AAGATAGTCCAGGTCCTAAGATAGAGGGAC
CTACCAGTCCAGGTCCTAAGATAGAGGGAC|GGACCGCAGGGTCTCCTTTTCATCCATGGT
AACAAGCGAGAGCCCTCCTGGGCCTCAGGC|GCAGGAGAAACGGATAGCGATTGTACTAGT
GAGGGACCGCAGGATGATTAGCACGCACCC|GCTTCCGTCCACGTACTGCAGATTCTTCAT
GAGGGACCGCAGGAAGATAGAGGGACCGCA|CTGCCTTTCCCACGCTCAGGGACTTTAAGC
TTCCCCCAACGGTACACGCTCGAAGCTGAT|ACGCCCCAAGGATTCGGTGGTGTTCCTAAT
GCGCCAAGTACATATGCTGCTTACCAATCG|TCAACAAGCGAGAGCCCTCCTGGGCCTCAG
GGTCCTACAGAAAATGGTCCAGGTCCTAAG|ATAGAGGGACCGCAGGCTATGTGGGCCAGG
AAGATGAGACTACGCATAGACGCATACCGC|CTAAGATAGAGGGACCGCAGGCGGCACGGT
GTCCAGGTCCTAAGATAGAGGGACCGCAGG|CCAATCGGACGTCCAGGTCCTAAGATAGAG
CGGTGGTGTTCCTAATCAAAGGATTAGAGC|CGACCACTAAGTCCAGGTCCTGTCCAGGTC
TCAATGGACTAGGGGTATGGGGACTAGTCC|TCTGGCACTATATCCTAGCTCATCAGCAAG
GTACGTGTGGTCCAGGTCCTAAGATAGAGG|GGGACCGCAGGGACGGTAGGCGTCCCCGGT
AGAGGGACCGCAGGAAGATAGAGGGACCGC|CCTGCCTTTCCCACGCTCAGGGACTTTAAG
AAGGGTCTGGTACACCACCGTCCAGGTCCT|GGTTGCTAGCACAAGTGCGATAAAGATGAG
TACCGCCGCATATGGCCACGCCCCAAGGAT|CACGGTCGCAGGTATCCTTACTACGCGTAC
TAGAGGGACCGCAGGATGATTAGCACGCAC|TCGCTTCCGTCCACGTACTGCAGATTCTTC
GTATTTCTTTAATTCTGATGCTTCATTTCA|ACTAAACCACAGAACTAAAGTCCAGGTCCT
GAGCCCTCCTGGGCCTCAGGCGCGGGGCTT|ACGGATAGCGATTGTACTAGTCCAGGTCCT
CTACCAACGTGCAGCGCGGCTTCTGGCACT|TCCTAAGATAGAGGGACCGCAGGCGCAGGG
TCCTAATCAAAGGATTAGAGCGATAGGCTT|AGTCCAGGTCCTGTCCAGGTCCTAAGATAG
TAGAGCGATAGGCTTAAGAGCCGTCTGTTG|CAGGTCCTAAGATAGAGGGACCGCAGGAAG
CCGTACGTGTGGTCCAGGTCCTAAGATAGA|GAGGGACCGCAGGGACGGTAGGCGTCCCCG
GGTCGTACCCTATTGCCAGTCAATATATTC|ACTACGGAGCAAGCCGTAAGCCTACTATGT
GCAGGAGACGCACAACGATACAAATTCCCT|CAGGTCCTAAGATAGTCCAGGTCCTAAGAT
GCCTCAGGCGCGGGGCTTATAGGTCCTACA|TGTACTAGTCCAGGTCCTAAGATAGAGGGA
TTACTACGCGTACCCGACCACTAAGTCCAG|TCCAGGTCCTAAGATAGAGGGACCGCAGGA
CCCAAGGATTCGGTGGTGTTCCTAATCAAA|TACGCGTACCCGACCACTAAGTCCAGGTCC
GACGGTAGGCGTCCCCGGTCCAGGTCCTAA|CCAGGTCCTAAGATAGAGGGACCGCAGGCG
ATTCGTCGCATATCTCTACTCAACAAGCGA|CTTGTTTCCGCAAATAAATCGGCAGGAGAA
CAGATCTCCCCCGCAGGCCCCTGTGTTCCC|CCGTATTTAAAGTCCAGGTCCTAAGATAGA
GTCCAGGTCCTAAGATAGAGGGACCGCAGG|CAAGATTCGTGACAAAGTCGGAGTCCAGGT
GTCCTAAGATAGAGGGACCGCAGGCGGCAC|CTCCTTTTCATCCATGGTCAATGGACTAGG
GACCGCAGGCCTTTCTACTAAACCACAGAA|CATGTTCCCCCAACGGTACACGCTCGAAGC
CCAGGTCCTGTCCAGGTCCTAAGATAGAGG|AGGAGACGCACAACGATACAAATTCCCTGC
CTTTCTACTAAACCACAGAACTAAAGTCCA|CAACGGTACACGCTCGAAGCTGATTCATTG
TTTAATTCTGATGCTTCATTTCAGAGGGCC|CACAGAACTAAAGTCCAGGTCCTAAGATAG
TAAGATAGTCCAGGTCCTAAGATAGAGGGA|GCGGACGCGTGTAAGGACACTGCGCCAAGT
GGACCGCAGGGACGGTAGGCGTCCCCGGTC|ACACCACCGTCCAGGTCCTAAGATAGAGGG
CTGCGCGGACGCGTGTAAGGACACTGCGCC|CTCTACATTCGTCGCATATCTCTACTCAAC
CCGCAGGCGTGGGTACTACGGAGCAAGCCG|AATGGTCCAGGTCCTAAGATAGAGGGACCG
CGACGCACTCCCCCTAGGTTGCTAGCACAA|TTAAGAGCCGTCTGTTGGTGATACTACCAG
GATTCGTGACAAAGTCGGAGTCCAGGTCCT|TATTGCCAGTCAATATATTCTGGGCCTGCG
GCCCTCCTGGGCCTCAGGCGCGGGGCTTAT|GGATAGCGATTGTACTAGTCCAGGTCCTAA
AACAAGGGTCTGGTACACCACCGTCCAGGT|CTAGGTTGCTAGCACAAGTGCGATAAAGAT
CGATAGGCTTAAGAGCCGTCTGTTGGTGAT|CCTAAGATAGAGGGACCGCAGGAAGATAGA
TGGGGTCGTACCCTATTGCCAGTCAATATA|GGTACTACGGAGCAAGCCGTAAGCCTACTA
AGCCGTAAGCCTACTATGTTAATACTCTAC|GACCGCAGGATGATTAGCACGCACCCCAGG
CCTAAGATAGAGGGACCGCAGGTTAAACAA|CTCTGAAAAGAGCGACGCACTCCCCCTAGG
GACCGCAGGTTAAACAAGGGTCTGGTACAC|GACGCACTCCCCCTAGGTTGCTAGCACAAG
TAAGTCCAGGTCCTGTCCAGGTCCTAAGAT|ACCGCAGGAGACGCACAACGATACAAATTC
GCATATCTCTACTCAACAAGCGAGAGCCCT|CCGCAAATAAATCGGCAGGAGAAACGGATA
ATCAAAGGATTAGAGCGATAGGCTTAAGAG|AGGTCCTGTCCAGGTCCTAAGATAGAGGGA
GGGACCGCAGGCGCAGGGTGATCCGTGGGG|CTAAGATAGAGGGACCGCAGGCGTGGGTAC
TACGGAGCAAGCCGTAAGCCTACTATGTTA|AGATAGAGGGACCGCAGGATGATTAGCACG
GACTAGTCCAGGTCCTAAGATAGAGGGACC|ATCAGCAAGATTCGTGACAAAGTCGGAGTC
CGCAGGCCCTGTTGTGTTCAGAATTCTGGG|GGTCCTAAGATAGAGGGACCGCAGGCCTTT
GCGCGGCTTCTGGCACTATATCCTAGCTCA|GGACCGCAGGCGCAGGGTGATCCGTGGGGT
ACCAGTCCAGGTCCTAAGATAGAGGGACCG|ACCGCAGGGTCTCCTTTTCATCCATGGTCA
TCTGTTGGTGATACTACCAGTCCAGGTCCT|CAGGAAGATAGAGGGACCGCAGGGTCTCCT
CCTAAGATAGAGGGACCGCAGGCGGCACGG|CCTTTTCATCCATGGTCAATGGACTAGGGG
ACCCTATTGCCAGTCAATATATTCTGGGCC|GAGCAAGCCGTAAGCCTACTATGTTAATAC
CGCAGGATGATTAGCACGCACCCCAGGCTT|TCCACGTACTGCAGATTCTTCATTGTATGA
CCACGCTCAGGGACTTTAAGCCTACCAACG|CCGCAGGGAGGGACGTCCAGGTCCTAAGAT
AGATCTCCCCCGCAGGCCCCTGTGTTCCCG|CGTATTTAAAGTCCAGGTCCTAAGATAGAG
CCCCCTAGGTTGCTAGCACAAGTGCGATAA|GTCTGTTGGTGATACTACCAGTCCAGGTCC
CTACATTCGTCGCATATCTCTACTCAACAA|CAGGCTTGTTTCCGCAAATAAATCGGCAGG
CAGGTCCTAAGATAGAGGGACCGCAGGCCT|ACCGCAGGCGTAGTCGAGCATGTTCCCCCA
GGAGGGACGTCCAGGTCCTAAGATAGAGGG|GCTGCTTACCAATCGGACGTCCAGGTCCTA
TGAACAGATCTCCCCCGCAGGCCCCTGTGT|AGGGCCGTATTTAAAGTCCAGGTCCTAAGA
GCAAGATTCGTGACAAAGTCGGAGTCCAGG|ACCCTATTGCCAGTCAATATATTCTGGGCC
AGAGGGACCGCAGGCGTAGTCGAGCATGTT|GCATAGACGCATACCGCCGCATATGGCCAC
TAGCACAAGTGCGATAAAGATGAGACTACG|ACTACCAGTCCAGGTCCTAAGATAGAGGGA
CCTTTCTACTAAACCACAGAACTAAAGTCC|CCAACGGTACACGCTCGAAGCTGATTCATT
CGTGGGGTCGTACCCTATTGCCAGTCAATA|TGGGTACTACGGAGCAAGCCGTAAGCCTAC
ATAGAGGGACCGCAGGCCTTTCTACTAAAC|AGTCGAGCATGTTCCCCCAACGGTACACGC
TTCATCCATGGTCAATGGACTAGGGGTATG|GCAGCGCGGCTTCTGGCACTATATCCTAGC
GGGACCGCAGGCGGCACGGTCGCAGGTATC|ATGGTCAATGGACTAGGGGTATGGGGACTA
TTAATACTCTACATTCGTCGCATATCTCTA|ACGCACCCCAGGCTTGTTTCCGCAAATAAA
TCTGGCACTATATCCTAGCTCATCAGCAAG|GGCGCAGGGTGATCCGTGGGGTCGTACCCT
TAAGGACACTGCGCCAAGTACATATGCTGC|ATATCTCTACTCAACAAGCGAGAGCCCTCC
ACTACGCGTACCCGACCACTAAGTCCAGGT|CAGGTCCTAAGATAGAGGGACCGCAGGAGA
CAGGCGTAGTCGAGCATGTTCCCCCAACGG|ATACCGCCGCATATGGCCACGCCCCAAGGA
AGGGACCGCAGGCCCTGTTGTGTTCAGAAT|GGTCCAGGTCCTAAGATAGAGGGACCGCAG
ATATTCTGGGCCTGCGCGGACGCGTGTAAG|CTATGTTAATACTCTACATTCGTCGCATAT
GACGCACTCCCCCTAGGTTGCTAGCACAAG|TAAGAGCCGTCTGTTGGTGATACTACCAGT
TAATCAAAGGATTAGAGCGATAGGCTTAAG|CCAGGTCCTGTCCAGGTCCTAAGATAGAGG
GGGCCGTATTTAAAGTCCAGGTCCTAAGAT|GATAGAGGGACCGCAGGTTAAACAAGGGTC
CGCATACCGCCGCATATGGCCACGCCCCAA|GCGGCACGGTCGCAGGTATCCTTACTACGC
TCCAGGTCCTAAGATAGAGGGACCGCAGGA|CAACGATACAAATTCCCTGCCTTTCCCACG
GATAGTCCAGGTCCTAAGATAGAGGGACCG|GACGCGTGTAAGGACACTGCGCCAAGTACA
TTGGTGATACTACCAGTCCAGGTCCTAAGA|AAGATAGAGGGACCGCAGGGTCTCCTTTTC
CCCCCGCAGGCCCCTGTGTTCCCGTACGTG|TAAAGTCCAGGTCCTAAGATAGAGGGACCG
ATATGGCCACGCCCCAAGGATTCGGTGGTG|AGGTATCCTTACTACGCGTACCCGACCACT
GTCCAGGTCCTAAGATAGAGGGACCGCAGG|ATAAAGATGAGACTACGCATAGACGCATAC
AGTCCAGGTCCTAAGATAGAGGGACCGCAG|TCATTGACACTCTGAAAAGAGCGACGCACT
TCCTGGGCCTCAGGCGCGGGGCTTATAGGT|AGCGATTGTACTAGTCCAGGTCCTAAGATA
CCTGCCTTTCCCACGCTCAGGGACTTTAAG|GATAGAGGGACCGCAGGGAGGGACGTCCAG
AGATTCGTGACAAAGTCGGAGTCCAGGTCC|CTATTGCCAGTCAATATATTCTGGGCCTGC
TAGAGGGACCGCAGGCCTTTCTACTAAACC|GTCGAGCATGTTCCCCCAACGGTACACGCT
CCTGTTGTGTTCAGAATTCTGGGTCGTATT|AGATAGAGGGACCGCAGGCCTTTCTACTAA
TTATAGGTCCTACAGAAAATGGTCCAGGTC|CTAAGATAGAGGGACCGCAGGCTATGTGGG
AGAACTAAAGTCCAGGTCCTAAGATAGAGG|AAGCTGATTCATTGACACTCTGAAAAGAGC
CCAGGTCCTAAGATAGTCCAGGTCCTAAGA|GGGCCTGCGCGGACGCGTGTAAGGACACTG
TCAGAATTCTGGGTCGTATTTCTTTAATTC|ACCGCAGGCCTTTCTACTAAACCACAGAAC
GCAGGCGTGGGTACTACGGAGCAAGCCGTA|TGGTCCAGGTCCTAAGATAGAGGGACCGCA
ACGCTCAGGGACTTTAAGCCTACCAACGTG|GCAGGGAGGGACGTCCAGGTCCTAAGATAG
CTGTCCAGGTCCTAAGATAGAGGGACCGCA|GCACAACGATACAAATTCCCTGCCTTTCCC
GGGACCGCAGGATGATTAGCACGCACCCCA|TTCCGTCCACGTACTGCAGATTCTTCATTG
ATCGGACGTCCAGGTCCTAAGATAGAGGGA|TCAGGCGCGGGGCTTATAGGTCCTACAGAA
AATTCTGATGCTTCATTTCAGAGGGCCGTA|AGAACTAAAGTCCAGGTCCTAAGATAGAGG
GCTCATCAGCAAGATTCGTGACAAAGTCGG|GGGGTCGTACCCTATTGCCAGTCAATATAT
GGTCCTAAGATAGAGGGACCGCAGGGACGG|AAACAAGGGTCTGGTACACCACCGTCCAGG
GGATGATTAGCACGCACCCCAGGCTTGTTT|CGTACTGCAGATTCTTCATTGTATGATCAT
GACCGCAGGGTCTCCTTTTCATCCATGGTC|TTTAAGCCTACCAACGTGCAGCGCGGCTTC
CAGGCGCGGGGCTTATAGGTCCTACAGAAA|CTAGTCCAGGTCCTAAGATAGAGGGACCGC
ATACCGCCGCATATGGCCACGCCCCAAGGA|GCACGGTCGCAGGTATCCTTACTACGCGTA
CATATCTCTACTCAACAAGCGAGAGCCCTC|CGCAAATAAATCGGCAGGAGAAACGGATAG
AAGTCCAGGTCCTAAGATAGAGGGACCGCA|GCAGGTTAAACAAGGGTCTGGTACACCACC
CAGGTCCTAAGATAGAGGGACCGCAGGGAC|TTAAACAAGGGTCTGGTACACCACCGTCCA
TACTCAACAAGCGAGAGCCCTCCTGGGCCT|AATCGGCAGGAGAAACGGATAGCGATTGTA
TCAAAGGATTAGAGCGATAGGCTTAAGAGC|GGTCCTGTCCAGGTCCTAAGATAGAGGGAC
GCAAGCCGTAAGCCTACTATGTTAATACTC|AGGGACCGCAGGATGATTAGCACGCACCCC
TCCTAAGATAGAGGGACCGCAGGCGGCACG|TCCTTTTCATCCATGGTCAATGGACTAGGG
GAGGGACCGCAGGCCCTGTTGTGTTCAGAA|CGGTCCAGGTCCTAAGATAGAGGGACCGCA
TAAGATAGAGGGACCGCAGGTTAAACAAGG|CTGAAAAGAGCGACGCACTCCCCCTAGGTT
AAATTCCCTGCCTTTCCCACGCTCAGGGAC|TCCTAAGATAGAGGGACCGCAGGGAGGGAC
GTTCAGAATTCTGGGTCGTATTTCTTTAAT|GGACCGCAGGCCTTTCTACTAAACCACAGA
GACAAAGTCGGAGTCCAGGTCCTAAGATAG|AGTCAATATATTCTGGGCCTGCGCGGACGC
GTCCTAAGATAGAGGGACCGCAGGGACGGT|AACAAGGGTCTGGTACACCACCGTCCAGGT
AGGGTGATCCGTGGGGTCGTACCCTATTGC|CCGCAGGCGTGGGTACTACGGAGCAAGCCG
GTATTTAAAGTCCAGGTCCTAAGATAGAGG|AGGGACCGCAGGTTAAACAAGGGTCTGGTA
AGGTCCTAAGATAGAGGGACCGCAGGCGCA|TCGGACGTCCAGGTCCTAAGATAGAGGGAC
GGCACTATATCCTAGCTCATCAGCAAGATT|GCAGGGTGATCCGTGGGGTCGTACCCTATT
ATCAGCAAGATTCGTGACAAAGTCGGAGTC|TCGTACCCTATTGCCAGTCAATATATTCTG
AGATAGAGGGACCGCAGGATGATTAGCACG|GGCTCGCTTCCGTCCACGTACTGCAGATTC
GGCGCAGGGTGATCCGTGGGGTCGTACCCT|AGGGACCGCAGGCGTGGGTACTACGGAGCA
TAGGTTGCTAGCACAAGTGCGATAAAGATG|TTGGTGATACTACCAGTCCAGGTCCTAAGA
TAGCACGCACCCCAGGCTTGTTTCCGCAAA|CAGATTCTTCATTGTATGATCATCCGGGCG
CAGGTCCTAAGATAGAGGGACCGCAGGAGA|GATTCGTGACAAAGTCGGAGTCCAGGTCCT
GAAGATAGAGGGACCGCAGGGTCTCCTTTT|CGCTCAGGGACTTTAAGCCTACCAACGTGC
CACTGCGCCAAGTACATATGCTGCTTACCA|CTACTCAACAAGCGAGAGCCCTCCTGGGCC
GATAGAGGGACCGCAGGAAGATAGAGGGAC|TTCCCTGCCTTTCCCACGCTCAGGGACTTT
TGTAAGGACACTGCGCCAAGTACATATGCT|GCATATCTCTACTCAACAAGCGAGAGCCCT
GTCGAGCATGTTCCCCCAACGGTACACGCT|GCATATGGCCACGCCCCAAGGATTCGGTGG
AGCGAGAGCCCTCCTGGGCCTCAGGCGCGG|GAGAAACGGATAGCGATTGTACTAGTCCAG
CAGGGTCTCCTTTTCATCCATGGTCAATGG|GCCTACCAACGTGCAGCGCGGCTTCTGGCA
GATAGAGGGACCGCAGGCGTGGGTACTACG|TCCTACAGAAAATGGTCCAGGTCCTAAGAT
GCTGATTCATTGACACTCTGAAAAGAGCGA|CCTAATCAAAGGATTAGAGCGATAGGCTTA
AATATATTCTGGGCCTGCGCGGACGCGTGT|CTACTATGTTAATACTCTACATTCGTCGCA
GACCGCAGGCCCTGTTGTGTTCAGAATTCT|CCAGGTCCTAAGATAGAGGGACCGCAGGCC
TCCAGGTCCTAAGATAGAGGGACCGCAGGT|ATTGACACTCTGAAAAGAGCGACGCACTCC
TCATCAGCAAGATTCGTGACAAAGTCGGAG|GGTCGTACCCTATTGCCAGTCAATATATTC
ACCCGACCACTAAGTCCAGGTCCTGTCCAG|AGATAGAGGGACCGCAGGAGACGCACAACG
TCAGGGACTTTAAGCCTACCAACGTGCAGC|GGAGGGACGTCCAGGTCCTAAGATAGAGGG
TCCTTACTACGCGTACCCGACCACTAAGTC|TAGTCCAGGTCCTAAGATAGAGGGACCGCA
TCCTAAGATAGAGGGACCGCAGGGAGGGAC|GGACACTGCGCCAAGTACATATGCTGCTTA
ATAGAGGGACCGCAGGTTAAACAAGGGTCT|AAAGAGCGACGCACTCCCCCTAGGTTGCTA
AAGATAGAGGGACCGCAGGCGTAGTCGAGC|ACTACGCATAGACGCATACCGCCGCATATG
CAGGTCCTAAGATAGAGGGACCGCAGGATG|TGTGGGCCAGGCTCGCTTCCGTCCACGTAC
ACCGCAGGCCTTTCTACTAAACCACAGAAC|ATGTTCCCCCAACGGTACACGCTCGAAGCT
TCCAGGTCCTGTCCAGGTCCTAAGATAGAG|CAGGAGACGCACAACGATACAAATTCCCTG
CTAATCAAAGGATTAGAGCGATAGGCTTAA|TCCAGGTCCTGTCCAGGTCCTAAGATAGAG
GAGTCCAGGTCCTAAGATAGTCCAGGTCCT|TTCTGGGCCTGCGCGGACGCGTGTAAGGAC
GTCCAGGTCCTAAGATAGTCCAGGTCCTAA|CTGGGCCTGCGCGGACGCGTGTAAGGACAC
CACTCCCCCTAGGTTGCTAGCACAAGTGCG|AGCCGTCTGTTGGTGATACTACCAGTCCAG
CCTAATCAAAGGATTAGAGCGATAGGCTTA|GTCCAGGTCCTGTCCAGGTCCTAAGATAGA
ATAGAGGGACCGCAGGCCCTGTTGTGTTCA|CCCCGGTCCAGGTCCTAAGATAGAGGGACC
TGGGCCTCAGGCGCGGGGCTTATAGGTCCT|GATTGTACTAGTCCAGGTCCTAAGATAGAG
GGTCCTAAGATAGAGGGACCGCAGGCGTAG|GATGAGACTACGCATAGACGCATACCGCCG
CTTCTGGCACTATATCCTAGCTCATCAGCA|CAGGCGCAGGGTGATCCGTGGGGTCGTACC
CCTCCTGGGCCTCAGGCGCGGGGCTTATAG|ATAGCGATTGTACTAGTCCAGGTCCTAAGA
CCAAGGATTCGGTGGTGTTCCTAATCAAAG|ACGCGTACCCGACCACTAAGTCCAGGTCCT
CTACTAAACCACAGAACTAAAGTCCAGGTC|GGTACACGCTCGAAGCTGATTCATTGACAC
CTAAAGTCCAGGTCCTAAGATAGAGGGACC|TGATTCATTGACACTCTGAAAAGAGCGACG
GGCCCCTGTGTTCCCGTACGTGTGGTCCAG|AGGTCCTAAGATAGAGGGACCGCAGGGACG
GGGACGTCCAGGTCCTAAGATAGAGGGACC|GCTTACCAATCGGACGTCCAGGTCCTAAGA
ACTAAAGTCCAGGTCCTAAGATAGAGGGAC|CTGATTCATTGACACTCTGAAAAGAGCGAC
ACGCATACCGCCGCATATGGCCACGCCCCA|GGCGGCACGGTCGCAGGTATCCTTACTACG
ACGCGTACCCGACCACTAAGTCCAGGTCCT|GTCCTAAGATAGAGGGACCGCAGGAGACGC
TATCCTAGCTCATCAGCAAGATTCGTGACA|GATCCGTGGGGTCGTACCCTATTGCCAGTC
GGACCGCAGGCGCAGGGTGATCCGTGGGGT|TAAGATAGAGGGACCGCAGGCGTGGGTACT
GCCACGCCCCAAGGATTCGGTGGTGTTCCT|TCCTTACTACGCGTACCCGACCACTAAGTC
TGGTACACCACCGTCCAGGTCCTAAGATAG|AGCACAAGTGCGATAAAGATGAGACTACGC
CCAGTCAATATATTCTGGGCCTGCGCGGAC|GTAAGCCTACTATGTTAATACTCTACATTC
CTATTGCCAGTCAATATATTCTGGGCCTGC|CAAGCCGTAAGCCTACTATGTTAATACTCT
GTCCTAAGATAGTCCAGGTCCTAAGATAGA|CTGCGCGGACGCGTGTAAGGACACTGCGCC
CGGCTTCTGGCACTATATCCTAGCTCATCA|CCGCAGGCGCAGGGTGATCCGTGGGGTCGT
TCCTACAGAAAATGGTCCAGGTCCTAAGAT|AGAGGGACCGCAGGCTATGTGGGCCAGGCT
AGGGTCTCCTTTTCATCCATGGTCAATGGA|CCTACCAACGTGCAGCGCGGCTTCTGGCAC
TGTTAATACTCTACATTCGTCGCATATCTC|GCACGCACCCCAGGCTTGTTTCCGCAAATA
TGAGACTACGCATAGACGCATACCGCCGCA|GATAGAGGGACCGCAGGCGGCACGGTCGCA
CTTTTCATCCATGGTCAATGGACTAGGGGT|CGTGCAGCGCGGCTTCTGGCACTATATCCT
GATAAAGATGAGACTACGCATAGACGCATA|GGTCCTAAGATAGAGGGACCGCAGGCGGCA
ATTCTGATGCTTCATTTCAGAGGGCCGTAT|GAACTAAAGTCCAGGTCCTAAGATAGAGGG
CCCTATTGCCAGTCAATATATTCTGGGCCT|AGCAAGCCGTAAGCCTACTATGTTAATACT
CACTCTGAAAAGAGCGACGCACTCCCCCTA|TTAGAGCGATAGGCTTAAGAGCCGTCTGTT
ATTCTGGGCCTGCGCGGACGCGTGTAAGGA|ATGTTAATACTCTACATTCGTCGCATATCT
GGCTTAAGAGCCGTCTGTTGGTGATACTAC|GATAGAGGGACCGCAGGAAGATAGAGGGAC
AGGGACCGCAGGGAGGGACGTCCAGGTCCT|CAAGTACATATGCTGCTTACCAATCGGACG
TTCTGGCACTATATCCTAGCTCATCAGCAA|AGGCGCAGGGTGATCCGTGGGGTCGTACCC
AAATGGTCCAGGTCCTAAGATAGAGGGACC|GCAGGCTATGTGGGCCAGGCTCGCTTCCGT
GTCGTACCCTATTGCCAGTCAATATATTCT|CTACGGAGCAAGCCGTAAGCCTACTATGTT
GGACTAGGGGTATGGGGACTAGTCCAGGTC|CACTATATCCTAGCTCATCAGCAAGATTCG
AACTAAAGTCCAGGTCCTAAGATAGAGGGA|GCTGATTCATTGACACTCTGAAAAGAGCGA
TTTCCCACGCTCAGGGACTTTAAGCCTACC|GGGACCGCAGGGAGGGACGTCCAGGTCCTA
TCCTAAGATAGAGGGACCGCAGGTTAAACA|ACTCTGAAAAGAGCGACGCACTCCCCCTAG
GGTCCAGGTCCTAAGATAGAGGGACCGCAG|AGGGACCGCAGGCGTAGTCGAGCATGTTCC
GTTGTGTTCAGAATTCTGGGTCGTATTTCT|TAGAGGGACCGCAGGCCTTTCTACTAAACC
TTCCTAATCAAAGGATTAGAGCGATAGGCT|AAGTCCAGGTCCTGTCCAGGTCCTAAGATA
TAGGCTTAAGAGCCGTCTGTTGGTGATACT|AAGATAGAGGGACCGCAGGAAGATAGAGGG
CCCACGCTCAGGGACTTTAAGCCTACCAAC|ACCGCAGGGAGGGACGTCCAGGTCCTAAGA
ACCACCGTCCAGGTCCTAAGATAGAGGGAC|AGTGCGATAAAGATGAGACTACGCATAGAC
TTAAGCCTACCAACGTGCAGCGCGGCTTCT|TCCAGGTCCTAAGATAGAGGGACCGCAGGC
CTCAGGCGCGGGGCTTATAGGTCCTACAGA|TACTAGTCCAGGTCCTAAGATAGAGGGACC
CCGGTCCAGGTCCTAAGATAGAGGGACCGC|AGAGGGACCGCAGGCGTAGTCGAGCATGTT
CGTCCCCGGTCCAGGTCCTAAGATAGAGGG|AAGATAGAGGGACCGCAGGCGTAGTCGAGC
TCAGCAAGATTCGTGACAAAGTCGGAGTCC|CGTACCCTATTGCCAGTCAATATATTCTGG
TGGTCCAGGTCCTAAGATAGAGGGACCGCA|GGCTATGTGGGCCAGGCTCGCTTCCGTCCA
CCAATCGGACGTCCAGGTCCTAAGATAGAG|GCCTCAGGCGCGGGGCTTATAGGTCCTACA
TTCCCGTACGTGTGGTCCAGGTCCTAAGAT|ATAGAGGGACCGCAGGGACGGTAGGCGTCC
AGAGCGACGCACTCCCCCTAGGTTGCTAGC|AGGCTTAAGAGCCGTCTGTTGGTGATACTA
GTACACGCTCGAAGCTGATTCATTGACACT|ATTCGGTGGTGTTCCTAATCAAAGGATTAG
ACTAAGTCCAGGTCCTGTCCAGGTCCTAAG|GGACCGCAGGAGACGCACAACGATACAAAT
ATAGAGGGACCGCAGGGACGGTAGGCGTCC|TCTGGTACACCACCGTCCAGGTCCTAAGAT
TAGAGGGACCGCAGGGAGGGACGTCCAGGT|CGCCAAGTACATATGCTGCTTACCAATCGG
GTATCCTTACTACGCGTACCCGACCACTAA|GACTAGTCCAGGTCCTAAGATAGAGGGACC
AGCAAGATTCGTGACAAAGTCGGAGTCCAG|TACCCTATTGCCAGTCAATATATTCTGGGC
AAGTACATATGCTGCTTACCAATCGGACGT|AAGCGAGAGCCCTCCTGGGCCTCAGGCGCG
GAGGGACCGCAGGCGGCACGGTCGCAGGTA|CCATGGTCAATGGACTAGGGGTATGGGGAC
ATATGCTGCTTACCAATCGGACGTCCAGGT|GAGCCCTCCTGGGCCTCAGGCGCGGGGCTT
ACAAGCGAGAGCCCTCCTGGGCCTCAGGCG|CAGGAGAAACGGATAGCGATTGTACTAGTC
TCCATGGTCAATGGACTAGGGGTATGGGGA|CGCGGCTTCTGGCACTATATCCTAGCTCAT
CCAGGTCCTAAGATAGAGGGACCGCAGGGA|GTTAAACAAGGGTCTGGTACACCACCGTCC
TGCGCCAAGTACATATGCTGCTTACCAATC|CTCAACAAGCGAGAGCCCTCCTGGGCCTCA
ACGGTCGCAGGTATCCTTACTACGCGTACC|GGGGTATGGGGACTAGTCCAGGTCCTAAGA
TTCAGAGGGCCGTATTTAAAGTCCAGGTCC|TCCTAAGATAGAGGGACCGCAGGTTAAACA
ATTGCCAGTCAATATATTCTGGGCCTGCGC|AGCCGTAAGCCTACTATGTTAATACTCTAC
AGACGCATACCGCCGCATATGGCCACGCCC|CAGGCGGCACGGTCGCAGGTATCCTTACTA
CAGGCCCCTGTGTTCCCGTACGTGTGGTCC|CCAGGTCCTAAGATAGAGGGACCGCAGGGA
AAAGAGCGACGCACTCCCCCTAGGTTGCTA|ATAGGCTTAAGAGCCGTCTGTTGGTGATAC
AGTGAACAGATCTCCCCCGCAGGCCCCTGT|AGAGGGCCGTATTTAAAGTCCAGGTCCTAA
ACGTCCAGGTCCTAAGATAGAGGGACCGCA|CGCGGGGCTTATAGGTCCTACAGAAAATGG
GAGGGCCGTATTTAAAGTCCAGGTCCTAAG|AAGATAGAGGGACCGCAGGTTAAACAAGGG
ATAGAGGGACCGCAGGAGACGCACAACGAT|AAGTCGGAGTCCAGGTCCTAAGATAGTCCA
TAGAGGGACCGCAGGCGGCACGGTCGCAGG|ATCCATGGTCAATGGACTAGGGGTATGGGG
GACCGCAGGAGACGCACAACGATACAAATT|AGTCCAGGTCCTAAGATAGTCCAGGTCCTA
ACGCACCCCAGGCTTGTTTCCGCAAATAAA|TTCTTCATTGTATGATCATCCGGGCGGTCG
CACTATATCCTAGCTCATCAGCAAGATTCG|AGGGTGATCCGTGGGGTCGTACCCTATTGC
TGAAAAGAGCGACGCACTCCCCCTAGGTTG|GCGATAGGCTTAAGAGCCGTCTGTTGGTGA
AAGAGCCGTCTGTTGGTGATACTACCAGTC|AGGGACCGCAGGAAGATAGAGGGACCGCAG
ACTTTAAGCCTACCAACGTGCAGCGCGGCT|ACGTCCAGGTCCTAAGATAGAGGGACCGCA
TCAACAAGCGAGAGCCCTCCTGGGCCTCAG|CGGCAGGAGAAACGGATAGCGATTGTACTA
ATACTCTACATTCGTCGCATATCTCTACTC|CACCCCAGGCTTGTTTCCGCAAATAAATCG
TGATGCTTCATTTCAGAGGGCCGTATTTAA|TAAAGTCCAGGTCCTAAGATAGAGGGACCG
GGTACACCACCGTCCAGGTCCTAAGATAGA|GCACAAGTGCGATAAAGATGAGACTACGCA
TCGTATTTCTTTAATTCTGATGCTTCATTT|CTACTAAACCACAGAACTAAAGTCCAGGTC
AGCATGTTCCCCCAACGGTACACGCTCGAA|ATGGCCACGCCCCAAGGATTCGGTGGTGTT
GGTCCTAAGATAGAGGGACCGCAGGGAGGG|AAGGACACTGCGCCAAGTACATATGCTGCT
CCTTACTACGCGTACCCGACCACTAAGTCC|AGTCCAGGTCCTAAGATAGAGGGACCGCAG
ATCCGTGGGGTCGTACCCTATTGCCAGTCA|GCGTGGGTACTACGGAGCAAGCCGTAAGCC
AGGCGCAGGGTGATCCGTGGGGTCGTACCC|GAGGGACCGCAGGCGTGGGTACTACGGAGC
TCGAAGCTGATTCATTGACACTCTGAAAAG|GTGTTCCTAATCAAAGGATTAGAGCGATAG
GAGGGACCGCAGGGAGGGACGTCCAGGTCC|CCAAGTACATATGCTGCTTACCAATCGGAC
GTCCTAAGATAGAGGGACCGCAGGATGATT|GGGCCAGGCTCGCTTCCGTCCACGTACTGC
AAGGATTCGGTGGTGTTCCTAATCAAAGGA|GCGTACCCGACCACTAAGTCCAGGTCCTGT
TCTACTAAACCACAGAACTAAAGTCCAGGT|CGGTACACGCTCGAAGCTGATTCATTGACA
CCGACCACTAAGTCCAGGTCCTGTCCAGGT|ATAGAGGGACCGCAGGAGACGCACAACGAT
AGATAGAGGGACCGCAGGCGTGGGTACTAC|GTCCTACAGAAAATGGTCCAGGTCCTAAGA
CCGTCCAGGTCCTAAGATAGAGGGACCGCA|CGATAAAGATGAGACTACGCATAGACGCAT
CGCTCAGGGACTTTAAGCCTACCAACGTGC|CAGGGAGGGACGTCCAGGTCCTAAGATAGA
GGACCGCAGGCGTGGGTACTACGGAGCAAG|GAAAATGGTCCAGGTCCTAAGATAGAGGGA
ACGTGTGGTCCAGGTCCTAAGATAGAGGGA|GACCGCAGGGACGGTAGGCGTCCCCGGTCC
TAGTCCAGGTCCTAAGATAGAGGGACCGCA|CGCGTGTAAGGACACTGCGCCAAGTACATA
CAGGGACGGTAGGCGTCCCCGGTCCAGGTC|CCGTCCAGGTCCTAAGATAGAGGGACCGCA
CTCATCAGCAAGATTCGTGACAAAGTCGGA|GGGTCGTACCCTATTGCCAGTCAATATATT
CCAGTCCAGGTCCTAAGATAGAGGGACCGC|CCGCAGGGTCTCCTTTTCATCCATGGTCAA
TCCAGGTCCTAAGATAGAGGGACCGCAGGC|CAATCGGACGTCCAGGTCCTAAGATAGAGG
AAGATAGAGGGACCGCAGGGAGGGACGTCC|ACTGCGCCAAGTACATATGCTGCTTACCAA
CCGCCGCATATGGCCACGCCCCAAGGATTC|CGGTCGCAGGTATCCTTACTACGCGTACCC
CAATATATTCTGGGCCTGCGCGGACGCGTG|CCTACTATGTTAATACTCTACATTCGTCGC
ACGCGTGTAAGGACACTGCGCCAAGTACAT|TCGTCGCATATCTCTACTCAACAAGCGAGA
CCTAAGATAGAGGGACCGCAGGCGCAGGGT|ACGTCCAGGTCCTAAGATAGAGGGACCGCA
TAAGATAGAGGGACCGCAGGCGTAGTCGAG|GACTACGCATAGACGCATACCGCCGCATAT
CTGATTCATTGACACTCTGAAAAGAGCGAC|CTAATCAAAGGATTAGAGCGATAGGCTTAA
ATTCATTGACACTCTGAAAAGAGCGACGCA|ATCAAAGGATTAGAGCGATAGGCTTAAGAG
AGATAGAGGGACCGCAGGCCTTTCTACTAA|GTAGTCGAGCATGTTCCCCCAACGGTACAC
CGGTACACGCTCGAAGCTGATTCATTGACA|GGATTCGGTGGTGTTCCTAATCAAAGGATT
AACGGTACACGCTCGAAGCTGATTCATTGA|AAGGATTCGGTGGTGTTCCTAATCAAAGGA
TTGCCAGTCAATATATTCTGGGCCTGCGCG|GCCGTAAGCCTACTATGTTAATACTCTACA
CGTCTGTTGGTGATACTACCAGTCCAGGTC|CGCAGGAAGATAGAGGGACCGCAGGGTCTC
GCAGGGACGGTAGGCGTCCCCGGTCCAGGT|ACCGTCCAGGTCCTAAGATAGAGGGACCGC
CTTACTACGCGTACCCGACCACTAAGTCCA|GTCCAGGTCCTAAGATAGAGGGACCGCAGG
CCTACCAACGTGCAGCGCGGCTTCTGGCAC|GTCCTAAGATAGAGGGACCGCAGGCGCAGG
AAGATAGAGGGACCGCAGGGACGGTAGGCG|GGGTCTGGTACACCACCGTCCAGGTCCTAA
TTAATTCTGATGCTTCATTTCAGAGGGCCG|ACAGAACTAAAGTCCAGGTCCTAAGATAGA
AGGGACCGCAGGAGACGCACAACGATACAA|CGGAGTCCAGGTCCTAAGATAGTCCAGGTC
GTGACAAAGTCGGAGTCCAGGTCCTAAGAT|CCAGTCAATATATTCTGGGCCTGCGCGGAC
GCGGCACGGTCGCAGGTATCCTTACTACGC|GACTAGGGGTATGGGGACTAGTCCAGGTCC
AGAGGGACCGCAGGAGACGCACAACGATAC|GTCGGAGTCCAGGTCCTAAGATAGTCCAGG
AGAGGGACCGCAGGTTAAACAAGGGTCTGG|AGAGCGACGCACTCCCCCTAGGTTGCTAGC
CGTACGTGTGGTCCAGGTCCTAAGATAGAG|AGGGACCGCAGGGACGGTAGGCGTCCCCGG
GGGGTATGGGGACTAGTCCAGGTCCTAAGA|ATCCTAGCTCATCAGCAAGATTCGTGACAA
GAGGGACCGCAGGAGACGCACAACGATACA|TCGGAGTCCAGGTCCTAAGATAGTCCAGGT
TCCCCCGCAGGCCCCTGTGTTCCCGTACGT|TTAAAGTCCAGGTCCTAAGATAGAGGGACC
ATGTTAATACTCTACATTCGTCGCATATCT|AGCACGCACCCCAGGCTTGTTTCCGCAAAT
AGTCGAGCATGTTCCCCCAACGGTACACGC|CGCATATGGCCACGCCCCAAGGATTCGGTG
TGCTTACCAATCGGACGTCCAGGTCCTAAG|TCCTGGGCCTCAGGCGCGGGGCTTATAGGT
GTACTACGGAGCAAGCCGTAAGCCTACTAT|CCTAAGATAGAGGGACCGCAGGATGATTAG
GGGACCGCAGGCCTTTCTACTAAACCACAG|AGCATGTTCCCCCAACGGTACACGCTCGAA
CCCCTGTGTTCCCGTACGTGTGGTCCAGGT|GTCCTAAGATAGAGGGACCGCAGGGACGGT
AGATAGAGGGACCGCAGGGAGGGACGTCCA|CTGCGCCAAGTACATATGCTGCTTACCAAT
TAGGTCCTACAGAAAATGGTCCAGGTCCTA|AGATAGAGGGACCGCAGGCTATGTGGGCCA
AGCTGATTCATTGACACTCTGAAAAGAGCG|TCCTAATCAAAGGATTAGAGCGATAGGCTT
TAAGATAGAGGGACCGCAGGAAGATAGAGG|AAATTCCCTGCCTTTCCCACGCTCAGGGAC
CGGAGCAAGCCGTAAGCCTACTATGTTAAT|ATAGAGGGACCGCAGGATGATTAGCACGCA
GACCGCAGGATGATTAGCACGCACCCCAGG|CCGTCCACGTACTGCAGATTCTTCATTGTA
TCCAGGTCCTAAGATAGAGGGACCGCAGGC|AGGGTCTCCTTTTCATCCATGGTCAATGGA
GGTCCTAAGATAGAGGGACCGCAGGCCTTT|CGCAGGCGTAGTCGAGCATGTTCCCCCAAC
CTAAGTCCAGGTCCTGTCCAGGTCCTAAGA|GACCGCAGGAGACGCACAACGATACAAATT
GATTAGCACGCACCCCAGGCTTGTTTCCGC|CTGCAGATTCTTCATTGTATGATCATCCGG
TAAGAGCCGTCTGTTGGTGATACTACCAGT|GAGGGACCGCAGGAAGATAGAGGGACCGCA
TTCTGGGCCTGCGCGGACGCGTGTAAGGAC|TGTTAATACTCTACATTCGTCGCATATCTC
GATAGAGGGACCGCAGGAGACGCACAACGA|AAAGTCGGAGTCCAGGTCCTAAGATAGTCC
CCGCAGGGAGGGACGTCCAGGTCCTAAGAT|ACATATGCTGCTTACCAATCGGACGTCCAG
GTCTCCTTTTCATCCATGGTCAATGGACTA|ACCAACGTGCAGCGCGGCTTCTGGCACTAT
AAGTCCAGGTCCTGTCCAGGTCCTAAGATA|CCGCAGGAGACGCACAACGATACAAATTCC
CCCGTACGTGTGGTCCAGGTCCTAAGATAG|AGAGGGACCGCAGGGACGGTAGGCGTCCCC
GTACCCTATTGCCAGTCAATATATTCTGGG|CGGAGCAAGCCGTAAGCCTACTATGTTAAT
CTGCTTACCAATCGGACGTCCAGGTCCTAA|CTCCTGGGCCTCAGGCGCGGGGCTTATAGG
TCGTACCCTATTGCCAGTCAATATATTCTG|TACGGAGCAAGCCGTAAGCCTACTATGTTA
AGAGCCGTCTGTTGGTGATACTACCAGTCC|GGGACCGCAGGAAGATAGAGGGACCGCAGG
AAGATAGAGGGACCGCAGGCGGCACGGTCG|TTTCATCCATGGTCAATGGACTAGGGGTAT
CGCATATCTCTACTCAACAAGCGAGAGCCC|TCCGCAAATAAATCGGCAGGAGAAACGGAT
GTAAGGACACTGCGCCAAGTACATATGCTG|CATATCTCTACTCAACAAGCGAGAGCCCTC
CGAGCATGTTCCCCCAACGGTACACGCTCG|ATATGGCCACGCCCCAAGGATTCGGTGGTG
CTACGCATAGACGCATACCGCCGCATATGG|AGGGACCGCAGGCGGCACGGTCGCAGGTAT
CGCAGGCGCAGGGTGATCCGTGGGGTCGTA|ATAGAGGGACCGCAGGCGTGGGTACTACGG
CAGGGAGGGACGTCCAGGTCCTAAGATAGA|TATGCTGCTTACCAATCGGACGTCCAGGTC
AAGCTGATTCATTGACACTCTGAAAAGAGC|TTCCTAATCAAAGGATTAGAGCGATAGGCT
GTGATCCGTGGGGTCGTACCCTATTGCCAG|CAGGCGTGGGTACTACGGAGCAAGCCGTAA
CGTGCAGCGCGGCTTCTGGCACTATATCCT|ATAGAGGGACCGCAGGCGCAGGGTGATCCG
CCCAACGGTACACGCTCGAAGCTGATTCAT|CCCAAGGATTCGGTGGTGTTCCTAATCAAA
GACCACTAAGTCCAGGTCCTGTCCAGGTCC|AGAGGGACCGCAGGAGACGCACAACGATAC
CGCAGGTTAAACAAGGGTCTGGTACACCAC|GCACTCCCCCTAGGTTGCTAGCACAAGTGC
CGCACTCCCCCTAGGTTGCTAGCACAAGTG|AGAGCCGTCTGTTGGTGATACTACCAGTCC
AGGTCCTAAGATAGAGGGACCGCAGGCGTA|AGATGAGACTACGCATAGACGCATACCGCC
ACAAGTGCGATAAAGATGAGACTACGCATA|CCAGTCCAGGTCCTAAGATAGAGGGACCGC
TGGGTACTACGGAGCAAGCCGTAAGCCTAC|GGTCCTAAGATAGAGGGACCGCAGGATGAT
TAAAGTCCAGGTCCTAAGATAGAGGGACCG|GATTCATTGACACTCTGAAAAGAGCGACGC
AATTCTGGGTCGTATTTCTTTAATTCTGAT|CAGGCCTTTCTACTAAACCACAGAACTAAA
AAGATAGAGGGACCGCAGGAAGATAGAGGG|AATTCCCTGCCTTTCCCACGCTCAGGGACT
CCGCAGGCGTAGTCGAGCATGTTCCCCCAA|CGCATACCGCCGCATATGGCCACGCCCCAA
CAGCGAAGTGAACAGATCTCCCCCGCAGGC|CATTTCAGAGGGCCGTATTTAAAGTCCAGG
AGAGGGCCGTATTTAAAGTCCAGGTCCTAA|TAAGATAGAGGGACCGCAGGTTAAACAAGG
CAGGTCCTAAGATAGAGGGACCGCAGGCGT|AAGATGAGACTACGCATAGACGCATACCGC
GGCCTTTCTACTAAACCACAGAACTAAAGT|CCCCAACGGTACACGCTCGAAGCTGATTCA
ATATCTCTACTCAACAAGCGAGAGCCCTCC|GCAAATAAATCGGCAGGAGAAACGGATAGC
AAGCCGTAAGCCTACTATGTTAATACTCTA|GGACCGCAGGATGATTAGCACGCACCCCAG
AGAGGGACCGCAGGCCTTTCTACTAAACCA|TCGAGCATGTTCCCCCAACGGTACACGCTC
TACTACGGAGCAAGCCGTAAGCCTACTATG|CTAAGATAGAGGGACCGCAGGATGATTAGC
GTCCTAAGATAGAGGGACCGCAGGCCTTTC|GCAGGCGTAGTCGAGCATGTTCCCCCAACG
GCACTATATCCTAGCTCATCAGCAAGATTC|CAGGGTGATCCGTGGGGTCGTACCCTATTG
ACCGCAGGATGATTAGCACGCACCCCAGGC|CGTCCACGTACTGCAGATTCTTCATTGTAT
GACGTCCAGGTCCTAAGATAGAGGGACCGC|GCGCGGGGCTTATAGGTCCTACAGAAAATG
GTTCCTAATCAAAGGATTAGAGCGATAGGC|TAAGTCCAGGTCCTGTCCAGGTCCTAAGAT
CGCAGGCGTAGTCGAGCATGTTCCCCCAAC|GCATACCGCCGCATATGGCCACGCCCCAAG
TGGTCAATGGACTAGGGGTATGGGGACTAG|GCTTCTGGCACTATATCCTAGCTCATCAGC
TGACAAAGTCGGAGTCCAGGTCCTAAGATA|CAGTCAATATATTCTGGGCCTGCGCGGACG
TCCTAAGATAGAGGGACCGCAGGAAGATAG|TACAAATTCCCTGCCTTTCCCACGCTCAGG
ATGGTCAATGGACTAGGGGTATGGGGACTA|GGCTTCTGGCACTATATCCTAGCTCATCAG
TATGGCCACGCCCCAAGGATTCGGTGGTGT|GGTATCCTTACTACGCGTACCCGACCACTA
CATAGACGCATACCGCCGCATATGGCCACG|CCGCAGGCGGCACGGTCGCAGGTATCCTTA
AGCTCATCAGCAAGATTCGTGACAAAGTCG|TGGGGTCGTACCCTATTGCCAGTCAATATA
ACTCAACAAGCGAGAGCCCTCCTGGGCCTC|ATCGGCAGGAGAAACGGATAGCGATTGTAC
ACTAGGGGTATGGGGACTAGTCCAGGTCCT|CTATATCCTAGCTCATCAGCAAGATTCGTG
TACTACGCGTACCCGACCACTAAGTCCAGG|CCAGGTCCTAAGATAGAGGGACCGCAGGAG
CTAAACCACAGAACTAAAGTCCAGGTCCTA|ACACGCTCGAAGCTGATTCATTGACACTCT
AGCCGTCTGTTGGTGATACTACCAGTCCAG|GACCGCAGGAAGATAGAGGGACCGCAGGGT
CTTAAGAGCCGTCTGTTGGTGATACTACCA|TAGAGGGACCGCAGGAAGATAGAGGGACCG
GTCCTAAGATAGAGGGACCGCAGGCGCAGG|GGACGTCCAGGTCCTAAGATAGAGGGACCG
GGCGTCCCCGGTCCAGGTCCTAAGATAGAG|CTAAGATAGAGGGACCGCAGGCGTAGTCGA
CTGGGTCGTATTTCTTTAATTCTGATGCTT|CCTTTCTACTAAACCACAGAACTAAAGTCC
AACCACAGAACTAAAGTCCAGGTCCTAAGA|CGCTCGAAGCTGATTCATTGACACTCTGAA
GGTAGGCGTCCCCGGTCCAGGTCCTAAGAT|GGTCCTAAGATAGAGGGACCGCAGGCGTAG
CCGCAGGTTAAACAAGGGTCTGGTACACCA|CGCACTCCCCCTAGGTTGCTAGCACAAGTG
CCCCGGTCCAGGTCCTAAGATAGAGGGACC|ATAGAGGGACCGCAGGCGTAGTCGAGCATG
TCCAGGTCCTAAGATAGAGGGACCGCAGGG|GTGTAAGGACACTGCGCCAAGTACATATGC
AAAGATGAGACTACGCATAGACGCATACCG|CCTAAGATAGAGGGACCGCAGGCGGCACGG
GAGCGACGCACTCCCCCTAGGTTGCTAGCA|GGCTTAAGAGCCGTCTGTTGGTGATACTAC
TAAACCACAGAACTAAAGTCCAGGTCCTAA|CACGCTCGAAGCTGATTCATTGACACTCTG
CAGGCGCAGGGTGATCCGTGGGGTCGTACC|AGAGGGACCGCAGGCGTGGGTACTACGGAG
GATAGGCTTAAGAGCCGTCTGTTGGTGATA|CTAAGATAGAGGGACCGCAGGAAGATAGAG
ACAGAAAATGGTCCAGGTCCTAAGATAGAG|GGACCGCAGGCTATGTGGGCCAGGCTCGCT
ATCTCTACTCAACAAGCGAGAGCCCTCCTG|AAATAAATCGGCAGGAGAAACGGATAGCGA
GGAAGATAGAGGGACCGCAGGGTCTCCTTT|ACGCTCAGGGACTTTAAGCCTACCAACGTG
CATGGTCAATGGACTAGGGGTATGGGGACT|CGGCTTCTGGCACTATATCCTAGCTCATCA
TCTGGGTCGTATTTCTTTAATTCTGATGCT|GCCTTTCTACTAAACCACAGAACTAAAGTC
AGAGGGACCGCAGGGTCTCCTTTTCATCCA|GGGACTTTAAGCCTACCAACGTGCAGCGCG
TCATTGACACTCTGAAAAGAGCGACGCACT|CAAAGGATTAGAGCGATAGGCTTAAGAGCC
TCCTTTTCATCCATGGTCAATGGACTAGGG|AACGTGCAGCGCGGCTTCTGGCACTATATC
AAAGTCCAGGTCCTAAGATAGAGGGACCGC|ATTCATTGACACTCTGAAAAGAGCGACGCA
CAATGGACTAGGGGTATGGGGACTAGTCCA|CTGGCACTATATCCTAGCTCATCAGCAAGA
CAAGGATTCGGTGGTGTTCCTAATCAAAGG|CGCGTACCCGACCACTAAGTCCAGGTCCTG
CCTAAGATAGAGGGACCGCAGGAAGATAGA|ACAAATTCCCTGCCTTTCCCACGCTCAGGG
GGATTCGGTGGTGTTCCTAATCAAAGGATT|GTACCCGACCACTAAGTCCAGGTCCTGTCC
ATCCTTACTACGCGTACCCGACCACTAAGT|CTAGTCCAGGTCCTAAGATAGAGGGACCGC
CGCGTACCCGACCACTAAGTCCAGGTCCTG|TCCTAAGATAGAGGGACCGCAGGAGACGCA
GTCCTAAGATAGAGGGACCGCAGGCGTAGT|ATGAGACTACGCATAGACGCATACCGCCGC
CAGGCCCTGTTGTGTTCAGAATTCTGGGTC|TCCTAAGATAGAGGGACCGCAGGCCTTTCT
TCTGAAAAGAGCGACGCACTCCCCCTAGGT|GAGCGATAGGCTTAAGAGCCGTCTGTTGGT
GTCCAGGTCCTAAGATAGAGGGACCGCAGG|CAGGGTCTCCTTTTCATCCATGGTCAATGG
CACCCCAGGCTTGTTTCCGCAAATAAATCG|TTCATTGTATGATCATCCGGGCGGTCGACT
AAAATGGTCCAGGTCCTAAGATAGAGGGAC|CGCAGGCTATGTGGGCCAGGCTCGCTTCCG
GTGCAGCGCGGCTTCTGGCACTATATCCTA|TAGAGGGACCGCAGGCGCAGGGTGATCCGT
AGGGACCGCAGGCGTAGTCGAGCATGTTCC|ATAGACGCATACCGCCGCATATGGCCACGC
GTCCAGGTCCTGTCCAGGTCCTAAGATAGA|GCAGGAGACGCACAACGATACAAATTCCCT
CCAACGGTACACGCTCGAAGCTGATTCATT|CCAAGGATTCGGTGGTGTTCCTAATCAAAG
CGTAAGCCTACTATGTTAATACTCTACATT|CGCAGGATGATTAGCACGCACCCCAGGCTT
AGCGATAGGCTTAAGAGCCGTCTGTTGGTG|GTCCTAAGATAGAGGGACCGCAGGAAGATA
ATGCTTCATTTCAGAGGGCCGTATTTAAAG|AAGTCCAGGTCCTAAGATAGAGGGACCGCA
AAGCGAGAGCCCTCCTGGGCCTCAGGCGCG|GGAGAAACGGATAGCGATTGTACTAGTCCA
GGGTCTCCTTTTCATCCATGGTCAATGGAC|CTACCAACGTGCAGCGCGGCTTCTGGCACT
GGACTAGTCCAGGTCCTAAGATAGAGGGAC|CATCAGCAAGATTCGTGACAAAGTCGGAGT
AGATAGAGGGACCGCAGGGTCTCCTTTTCA|CTCAGGGACTTTAAGCCTACCAACGTGCAG
GTTCCCGTACGTGTGGTCCAGGTCCTAAGA|GATAGAGGGACCGCAGGGACGGTAGGCGTC
GTCCTAAGATAGAGGGACCGCAGGAGACGC|TCGTGACAAAGTCGGAGTCCAGGTCCTAAG
GGTTAAACAAGGGTCTGGTACACCACCGTC|TCCCCCTAGGTTGCTAGCACAAGTGCGATA
GATTAGAGCGATAGGCTTAAGAGCCGTCTG|GTCCAGGTCCTAAGATAGAGGGACCGCAGG
ACCGCAGGCGTGGGTACTACGGAGCAAGCC|AAATGGTCCAGGTCCTAAGATAGAGGGACC
TAGTCCAGGTCCTAAGATAGAGGGACCGCA|AGCAAGATTCGTGACAAAGTCGGAGTCCAG
CTGCCTTTCCCACGCTCAGGGACTTTAAGC|ATAGAGGGACCGCAGGGAGGGACGTCCAGG
TCTACTCAACAAGCGAGAGCCCTCCTGGGC|TAAATCGGCAGGAGAAACGGATAGCGATTG
TTCGTCGCATATCTCTACTCAACAAGCGAG|TTGTTTCCGCAAATAAATCGGCAGGAGAAA
ATTGACACTCTGAAAAGAGCGACGCACTCC|AAGGATTAGAGCGATAGGCTTAAGAGCCGT
CCTACTATGTTAATACTCTACATTCGTCGC|ATGATTAGCACGCACCCCAGGCTTGTTTCC
TGTGTTCCCGTACGTGTGGTCCAGGTCCTA|TAAGATAGAGGGACCGCAGGGACGGTAGGC
GGTGTTCCTAATCAAAGGATTAGAGCGATA|CACTAAGTCCAGGTCCTGTCCAGGTCCTAA
GCAGGCGCAGGGTGATCCGTGGGGTCGTAC|TAGAGGGACCGCAGGCGTGGGTACTACGGA
AGATAGTCCAGGTCCTAAGATAGAGGGACC|GGACGCGTGTAAGGACACTGCGCCAAGTAC
CGTGACAAAGTCGGAGTCCAGGTCCTAAGA|GCCAGTCAATATATTCTGGGCCTGCGCGGA
GGTCGCAGGTATCCTTACTACGCGTACCCG|GGTATGGGGACTAGTCCAGGTCCTAAGATA
GTCAATATATTCTGGGCCTGCGCGGACGCG|AGCCTACTATGTTAATACTCTACATTCGTC
AGATAGAGGGACCGCAGGAGACGCACAACG|CAAAGTCGGAGTCCAGGTCCTAAGATAGTC
CAGGATGATTAGCACGCACCCCAGGCTTGT|CACGTACTGCAGATTCTTCATTGTATGATC
TCCCTGCCTTTCCCACGCTCAGGGACTTTA|AAGATAGAGGGACCGCAGGGAGGGACGTCC
AGAGCCCTCCTGGGCCTCAGGCGCGGGGCT|AACGGATAGCGATTGTACTAGTCCAGGTCC
CCGCAGGAGACGCACAACGATACAAATTCC|TCCAGGTCCTAAGATAGTCCAGGTCCTAAG
GTGAACAGATCTCCCCCGCAGGCCCCTGTG|GAGGGCCGTATTTAAAGTCCAGGTCCTAAG
TCATCCATGGTCAATGGACTAGGGGTATGG|CAGCGCGGCTTCTGGCACTATATCCTAGCT
AGACGCACAACGATACAAATTCCCTGCCTT|CCTAAGATAGTCCAGGTCCTAAGATAGAGG
GGCCCTGTTGTGTTCAGAATTCTGGGTCGT|CTAAGATAGAGGGACCGCAGGCCTTTCTAC
TAAACAAGGGTCTGGTACACCACCGTCCAG|CCCTAGGTTGCTAGCACAAGTGCGATAAAG
ACTACCAGTCCAGGTCCTAAGATAGAGGGA|GGGACCGCAGGGTCTCCTTTTCATCCATGG
TCCAGGTCCTAAGATAGAGGGACCGCAGGC|GGACCGCAGGCGTAGTCGAGCATGTTCCCC
CCGCAGGCGGCACGGTCGCAGGTATCCTTA|TCAATGGACTAGGGGTATGGGGACTAGTCC
GAGGGACCGCAGGCCTTTCTACTAAACCAC|CGAGCATGTTCCCCCAACGGTACACGCTCG
GGGACCGCAGGGAGGGACGTCCAGGTCCTA|AAGTACATATGCTGCTTACCAATCGGACGT
CTTTCCCACGCTCAGGGACTTTAAGCCTAC|AGGGACCGCAGGGAGGGACGTCCAGGTCCT
TAAGATAGAGGGACCGCAGGCGTGGGTACT|AGGTCCTACAGAAAATGGTCCAGGTCCTAA
GGGGTCGTACCCTATTGCCAGTCAATATAT|GTACTACGGAGCAAGCCGTAAGCCTACTAT
GCGTAGTCGAGCATGTTCCCCCAACGGTAC|CCGCCGCATATGGCCACGCCCCAAGGATTC
AGAGGGACCGCAGGATGATTAGCACGCACC|CGCTTCCGTCCACGTACTGCAGATTCTTCA
ACCGCAGGCGTAGTCGAGCATGTTCCCCCA|ACGCATACCGCCGCATATGGCCACGCCCCA
AGATAGAGGGACCGCAGGGACGGTAGGCGT|GGTCTGGTACACCACCGTCCAGGTCCTAAG
GAGGGACCGCAGGGTCTCCTTTTCATCCAT|GGACTTTAAGCCTACCAACGTGCAGCGCGG
TCCGTGGGGTCGTACCCTATTGCCAGTCAA|CGTGGGTACTACGGAGCAAGCCGTAAGCCT
CCTAAGATAGAGGGACCGCAGGGAGGGACG|GACACTGCGCCAAGTACATATGCTGCTTAC
CCGTATTTAAAGTCCAGGTCCTAAGATAGA|AGAGGGACCGCAGGTTAAACAAGGGTCTGG
AATTCCCTGCCTTTCCCACGCTCAGGGACT|CCTAAGATAGAGGGACCGCAGGGAGGGACG
ACTCTGAAAAGAGCGACGCACTCCCCCTAG|TAGAGCGATAGGCTTAAGAGCCGTCTGTTG
CGTATTTAAAGTCCAGGTCCTAAGATAGAG|GAGGGACCGCAGGTTAAACAAGGGTCTGGT
CGGGGCTTATAGGTCCTACAGAAAATGGTC|CAGGTCCTAAGATAGAGGGACCGCAGGCTA
CCCCTAGGTTGCTAGCACAAGTGCGATAAA|TCTGTTGGTGATACTACCAGTCCAGGTCCT
TTTCTACTAAACCACAGAACTAAAGTCCAG|AACGGTACACGCTCGAAGCTGATTCATTGA
GAACAGATCTCCCCCGCAGGCCCCTGTGTT|GGGCCGTATTTAAAGTCCAGGTCCTAAGAT
GCTCGAAGCTGATTCATTGACACTCTGAAA|TGGTGTTCCTAATCAAAGGATTAGAGCGAT
GGTCCTAAGATAGAGGGACCGCAGGCGCAG|CGGACGTCCAGGTCCTAAGATAGAGGGACC
GTCCAGGTCCTAAGATAGAGGGACCGCAGG|CTATGTGGGCCAGGCTCGCTTCCGTCCACG
CACAACGATACAAATTCCCTGCCTTTCCCA|GATAGTCCAGGTCCTAAGATAGAGGGACCG
TAAGCCTACTATGTTAATACTCTACATTCG|CAGGATGATTAGCACGCACCCCAGGCTTGT
GGTCGTATTTCTTTAATTCTGATGCTTCAT|TTCTACTAAACCACAGAACTAAAGTCCAGG
CAGGTCCTAAGATAGAGGGACCGCAGGCGT|GGCTTATAGGTCCTACAGAAAATGGTCCAG
ACAAGGGTCTGGTACACCACCGTCCAGGTC|TAGGTTGCTAGCACAAGTGCGATAAAGATG
AGATAGAGGGACCGCAGGCGGCACGGTCGC|TTCATCCATGGTCAATGGACTAGGGGTATG
CAGGTATCCTTACTACGCGTACCCGACCAC|GGGGACTAGTCCAGGTCCTAAGATAGAGGG
CCGTAAGCCTACTATGTTAATACTCTACAT|CCGCAGGATGATTAGCACGCACCCCAGGCT
ATTTCTTTAATTCTGATGCTTCATTTCAGA|TAAACCACAGAACTAAAGTCCAGGTCCTAA
CTAGCTCATCAGCAAGATTCGTGACAAAGT|CGTGGGGTCGTACCCTATTGCCAGTCAATA
CCTGGGCCTCAGGCGCGGGGCTTATAGGTC|GCGATTGTACTAGTCCAGGTCCTAAGATAG
GAACTAAAGTCCAGGTCCTAAGATAGAGGG|AGCTGATTCATTGACACTCTGAAAAGAGCG
CCTACAGAAAATGGTCCAGGTCCTAAGATA|GAGGGACCGCAGGCTATGTGGGCCAGGCTC
CCGCAGGAAGATAGAGGGACCGCAGGGTCT|TTCCCACGCTCAGGGACTTTAAGCCTACCA
CTAAGATAGAGGGACCGCAGGCGGCACGGT|CTTTTCATCCATGGTCAATGGACTAGGGGT
TCCAGGTCCTAAGATAGAGGGACCGCAGGA|AAGATTCGTGACAAAGTCGGAGTCCAGGTC
ACACCACCGTCCAGGTCCTAAGATAGAGGG|CAAGTGCGATAAAGATGAGACTACGCATAG
CGCGTGTAAGGACACTGCGCCAAGTACATA|CGTCGCATATCTCTACTCAACAAGCGAGAG
ACCGCCGCATATGGCCACGCCCCAAGGATT|ACGGTCGCAGGTATCCTTACTACGCGTACC
TCGGAGTCCAGGTCCTAAGATAGTCCAGGT|ATATTCTGGGCCTGCGCGGACGCGTGTAAG
TTACCAATCGGACGTCCAGGTCCTAAGATA|TGGGCCTCAGGCGCGGGGCTTATAGGTCCT
CTGGGCCTCAGGCGCGGGGCTTATAGGTCC|CGATTGTACTAGTCCAGGTCCTAAGATAGA
CGTCCAGGTCCTAAGATAGAGGGACCGCAG|GCGGGGCTTATAGGTCCTACAGAAAATGGT
CCAGGTCCTAAGATAGAGGGACCGCAGGGA|TGTAAGGACACTGCGCCAAGTACATATGCT
CCACTAAGTCCAGGTCCTGTCCAGGTCCTA|AGGGACCGCAGGAGACGCACAACGATACAA
TTCGTGACAAAGTCGGAGTCCAGGTCCTAA|TTGCCAGTCAATATATTCTGGGCCTGCGCG
GATAGAGGGACCGCAGGCGCAGGGTGATCC|CAGGTCCTAAGATAGAGGGACCGCAGGCGT
ATCTCCCCCGCAGGCCCCTGTGTTCCCGTA|TATTTAAAGTCCAGGTCCTAAGATAGAGGG
TACAAATTCCCTGCCTTTCCCACGCTCAGG|AGGTCCTAAGATAGAGGGACCGCAGGGAGG
CGCAGGCGTGGGTACTACGGAGCAAGCCGT|ATGGTCCAGGTCCTAAGATAGAGGGACCGC
AGGGACCGCAGGGTCTCCTTTTCATCCATG|GACTTTAAGCCTACCAACGTGCAGCGCGGC
CGGCACGGTCGCAGGTATCCTTACTACGCG|ACTAGGGGTATGGGGACTAGTCCAGGTCCT
CCCTGTGTTCCCGTACGTGTGGTCCAGGTC|TCCTAAGATAGAGGGACCGCAGGGACGGTA
CCAACGTGCAGCGCGGCTTCTGGCACTATA|TAAGATAGAGGGACCGCAGGCGCAGGGTGA
GGGGCTTATAGGTCCTACAGAAAATGGTCC|AGGTCCTAAGATAGAGGGACCGCAGGCTAT
GGTACTACGGAGCAAGCCGTAAGCCTACTA|TCCTAAGATAGAGGGACCGCAGGATGATTA
GCCAAGTACATATGCTGCTTACCAATCGGA|AACAAGCGAGAGCCCTCCTGGGCCTCAGGC
ACTACGCATAGACGCATACCGCCGCATATG|GAGGGACCGCAGGCGGCACGGTCGCAGGTA
ATACAAATTCCCTGCCTTTCCCACGCTCAG|CAGGTCCTAAGATAGAGGGACCGCAGGGAG
ACGCATAGACGCATACCGCCGCATATGGCC|GGACCGCAGGCGGCACGGTCGCAGGTATCC
CCTGTCCAGGTCCTAAGATAGAGGGACCGC|CGCACAACGATACAAATTCCCTGCCTTTCC
TAGAGGGACCGCAGGTTAAACAAGGGTCTG|AAGAGCGACGCACTCCCCCTAGGTTGCTAG
CTAGTCCAGGTCCTAAGATAGAGGGACCGC|CAGCAAGATTCGTGACAAAGTCGGAGTCCA
GCTTACCAATCGGACGTCCAGGTCCTAAGA|CCTGGGCCTCAGGCGCGGGGCTTATAGGTC
GTCCAGGTCCTAAGATAGAGGGACCGCAGG|AGGTTAAACAAGGGTCTGGTACACCACCGT
AGTACATATGCTGCTTACCAATCGGACGTC|AGCGAGAGCCCTCCTGGGCCTCAGGCGCGG
GGGTCTGGTACACCACCGTCCAGGTCCTAA|TTGCTAGCACAAGTGCGATAAAGATGAGAC
AGCCTACTATGTTAATACTCTACATTCGTC|GGATGATTAGCACGCACCCCAGGCTTGTTT
GGAGCAAGCCGTAAGCCTACTATGTTAATA|TAGAGGGACCGCAGGATGATTAGCACGCAC
TAGGGGTATGGGGACTAGTCCAGGTCCTAA|ATATCCTAGCTCATCAGCAAGATTCGTGAC
TCCTAAGATAGAGGGACCGCAGGCGCAGGG|GACGTCCAGGTCCTAAGATAGAGGGACCGC
CTCAACAAGCGAGAGCCCTCCTGGGCCTCA|TCGGCAGGAGAAACGGATAGCGATTGTACT
AAAAGAGCGACGCACTCCCCCTAGGTTGCT|GATAGGCTTAAGAGCCGTCTGTTGGTGATA
ACCGCAGGCGCAGGGTGATCCGTGGGGTCG|AGATAGAGGGACCGCAGGCGTGGGTACTAC
ACGGTACACGCTCGAAGCTGATTCATTGAC|AGGATTCGGTGGTGTTCCTAATCAAAGGAT
AGTCGGAGTCCAGGTCCTAAGATAGTCCAG|ATATATTCTGGGCCTGCGCGGACGCGTGTA
GTCCTGTCCAGGTCCTAAGATAGAGGGACC|GACGCACAACGATACAAATTCCCTGCCTTT
TAATTCTGATGCTTCATTTCAGAGGGCCGT|CAGAACTAAAGTCCAGGTCCTAAGATAGAG
GGACCGCAGGCGGCACGGTCGCAGGTATCC|TGGTCAATGGACTAGGGGTATGGGGACTAG
GCAGGCGGCACGGTCGCAGGTATCCTTACT|AATGGACTAGGGGTATGGGGACTAGTCCAG
CCACAGAACTAAAGTCCAGGTCCTAAGATA|CTCGAAGCTGATTCATTGACACTCTGAAAA
GGTCCTAAGATAGTCCAGGTCCTAAGATAG|CCTGCGCGGACGCGTGTAAGGACACTGCGC
AAGATAGAGGGACCGCAGGCCCTGTTGTGT|CGTCCCCGGTCCAGGTCCTAAGATAGAGGG
GCTTCTGGCACTATATCCTAGCTCATCAGC|GCAGGCGCAGGGTGATCCGTGGGGTCGTAC
CCTCAGGCGCGGGGCTTATAGGTCCTACAG|GTACTAGTCCAGGTCCTAAGATAGAGGGAC
ATAGAGGGACCGCAGGATGATTAGCACGCA|CTCGCTTCCGTCCACGTACTGCAGATTCTT
GTCCTAAGATAGAGGGACCGCAGGTTAAAC|CACTCTGAAAAGAGCGACGCACTCCCCCTA
ACCGCAGGCGGCACGGTCGCAGGTATCCTT|GTCAATGGACTAGGGGTATGGGGACTAGTC
CAGAACTAAAGTCCAGGTCCTAAGATAGAG|GAAGCTGATTCATTGACACTCTGAAAAGAG
GTCCCCGGTCCAGGTCCTAAGATAGAGGGA|AGATAGAGGGACCGCAGGCGTAGTCGAGCA
CGAGAGCCCTCCTGGGCCTCAGGCGCGGGG|GAAACGGATAGCGATTGTACTAGTCCAGGT
TCCTAAGATAGAGGGACCGCAGGCGTGGGT|TATAGGTCCTACAGAAAATGGTCCAGGTCC
ATGAGACTACGCATAGACGCATACCGCCGC|AGATAGAGGGACCGCAGGCGGCACGGTCGC
CAGAATTCTGGGTCGTATTTCTTTAATTCT|CCGCAGGCCTTTCTACTAAACCACAGAACT
GCAGCGCGGCTTCTGGCACTATATCCTAGC|GAGGGACCGCAGGCGCAGGGTGATCCGTGG
ATTCCCTGCCTTTCCCACGCTCAGGGACTT|CTAAGATAGAGGGACCGCAGGGAGGGACGT
GCCGTAAGCCTACTATGTTAATACTCTACA|ACCGCAGGATGATTAGCACGCACCCCAGGC
GATGATTAGCACGCACCCCAGGCTTGTTTC|GTACTGCAGATTCTTCATTGTATGATCATC
TGTTCCCGTACGTGTGGTCCAGGTCCTAAG|AGATAGAGGGACCGCAGGGACGGTAGGCGT
ACGTCCAGGTCCTAAGATAGAGGGACCGCA|TACCAATCGGACGTCCAGGTCCTAAGATAG
GCATAGACGCATACCGCCGCATATGGCCAC|ACCGCAGGCGGCACGGTCGCAGGTATCCTT
CTCCCCCGCAGGCCCCTGTGTTCCCGTACG|TTTAAAGTCCAGGTCCTAAGATAGAGGGAC
TGGTGATACTACCAGTCCAGGTCCTAAGAT|AGATAGAGGGACCGCAGGGTCTCCTTTTCA
GAGGGACCGCAGGCGTGGGTACTACGGAGC|ACAGAAAATGGTCCAGGTCCTAAGATAGAG
TGTTCCTAATCAAAGGATTAGAGCGATAGG|CTAAGTCCAGGTCCTGTCCAGGTCCTAAGA
GCACGGTCGCAGGTATCCTTACTACGCGTA|TAGGGGTATGGGGACTAGTCCAGGTCCTAA
AGCGAAGTGAACAGATCTCCCCCGCAGGCC|ATTTCAGAGGGCCGTATTTAAAGTCCAGGT
ATATATTCTGGGCCTGCGCGGACGCGTGTA|TACTATGTTAATACTCTACATTCGTCGCAT
CCTTTTCATCCATGGTCAATGGACTAGGGG|ACGTGCAGCGCGGCTTCTGGCACTATATCC
CCCGCAGGCCCCTGTGTTCCCGTACGTGTG|AAGTCCAGGTCCTAAGATAGAGGGACCGCA
CGTACCCTATTGCCAGTCAATATATTCTGG|ACGGAGCAAGCCGTAAGCCTACTATGTTAA
TTTTCATCCATGGTCAATGGACTAGGGGTA|GTGCAGCGCGGCTTCTGGCACTATATCCTA
TAGACGCATACCGCCGCATATGGCCACGCC|GCAGGCGGCACGGTCGCAGGTATCCTTACT
CCAGGTCCTAAGATAGAGGGACCGCAGGCG|GGGCTTATAGGTCCTACAGAAAATGGTCCA
GTACCCGACCACTAAGTCCAGGTCCTGTCC|TAAGATAGAGGGACCGCAGGAGACGCACAA
CTAAGATAGAGGGACCGCAGGTTAAACAAG|TCTGAAAAGAGCGACGCACTCCCCCTAGGT
AAAGTCCAGGTCCTAAGATAGAGGGACCGC|CGCAGGTTAAACAAGGGTCTGGTACACCAC
GGAGACGCACAACGATACAAATTCCCTGCC|GTCCTAAGATAGTCCAGGTCCTAAGATAGA
CAAGGGTCTGGTACACCACCGTCCAGGTCC|AGGTTGCTAGCACAAGTGCGATAAAGATGA
CGAAGCTGATTCATTGACACTCTGAAAAGA|TGTTCCTAATCAAAGGATTAGAGCGATAGG
GTTAATACTCTACATTCGTCGCATATCTCT|CACGCACCCCAGGCTTGTTTCCGCAAATAA
GGGAGGGACGTCCAGGTCCTAAGATAGAGG|TGCTGCTTACCAATCGGACGTCCAGGTCCT
TATGCTGCTTACCAATCGGACGTCCAGGTC|AGCCCTCCTGGGCCTCAGGCGCGGGGCTTA
CGAAGTGAACAGATCTCCCCCGCAGGCCCC|TTCAGAGGGCCGTATTTAAAGTCCAGGTCC
AATACTCTACATTCGTCGCATATCTCTACT|GCACCCCAGGCTTGTTTCCGCAAATAAATC
CAGCGCGGCTTCTGGCACTATATCCTAGCT|AGGGACCGCAGGCGCAGGGTGATCCGTGGG
GACCGCAGGCGGCACGGTCGCAGGTATCCT|GGTCAATGGACTAGGGGTATGGGGACTAGT
ACGGAGCAAGCCGTAAGCCTACTATGTTAA|GATAGAGGGACCGCAGGATGATTAGCACGC
GTTGGTGATACTACCAGTCCAGGTCCTAAG|GAAGATAGAGGGACCGCAGGGTCTCCTTTT
CGATAAAGATGAGACTACGCATAGACGCAT|AGGTCCTAAGATAGAGGGACCGCAGGCGGC
AGTCAATATATTCTGGGCCTGCGCGGACGC|AAGCCTACTATGTTAATACTCTACATTCGT
GAGGGACCGCAGGGACGGTAGGCGTCCCCG|GGTACACCACCGTCCAGGTCCTAAGATAGA
GCGATAGGCTTAAGAGCCGTCTGTTGGTGA|TCCTAAGATAGAGGGACCGCAGGAAGATAG
AAGATAGAGGGACCGCAGGCCTTTCTACTA|CGTAGTCGAGCATGTTCCCCCAACGGTACA
CTAAGATAGAGGGACCGCAGGCGTAGTCGA|AGACTACGCATAGACGCATACCGCCGCATA
CAGGCGTGGGTACTACGGAGCAAGCCGTAA|GGTCCAGGTCCTAAGATAGAGGGACCGCAG
CACGCACCCCAGGCTTGTTTCCGCAAATAA|ATTCTTCATTGTATGATCATCCGGGCGGTC
CAACGGTACACGCTCGAAGCTGATTCATTG|CAAGGATTCGGTGGTGTTCCTAATCAAAGG
TGTTCCCCCAACGGTACACGCTCGAAGCTG|CCACGCCCCAAGGATTCGGTGGTGTTCCTA
CAAGATTCGTGACAAAGTCGGAGTCCAGGT|CCCTATTGCCAGTCAATATATTCTGGGCCT
GGTCTGGTACACCACCGTCCAGGTCCTAAG|TGCTAGCACAAGTGCGATAAAGATGAGACT
GAGACGCACAACGATACAAATTCCCTGCCT|TCCTAAGATAGTCCAGGTCCTAAGATAGAG
TCCCCCTAGGTTGCTAGCACAAGTGCGATA|CGTCTGTTGGTGATACTACCAGTCCAGGTC
AGTGCGATAAAGATGAGACTACGCATAGAC|GTCCAGGTCCTAAGATAGAGGGACCGCAGG
CTAAGATAGTCCAGGTCCTAAGATAGAGGG|CGCGGACGCGTGTAAGGACACTGCGCCAAG
GGGCCTCAGGCGCGGGGCTTATAGGTCCTA|ATTGTACTAGTCCAGGTCCTAAGATAGAGG
TGCGATAAAGATGAGACTACGCATAGACGC|CCAGGTCCTAAGATAGAGGGACCGCAGGCG
AGATAGAGGGACCGCAGGTTAAACAAGGGT|GAAAAGAGCGACGCACTCCCCCTAGGTTGC
AGAGGGACCGCAGGCGGCACGGTCGCAGGT|TCCATGGTCAATGGACTAGGGGTATGGGGA
CTCTACATTCGTCGCATATCTCTACTCAAC|CCCAGGCTTGTTTCCGCAAATAAATCGGCA
CCTAGGTTGCTAGCACAAGTGCGATAAAGA|TGTTGGTGATACTACCAGTCCAGGTCCTAA
GGACCGCAGGAGACGCACAACGATACAAAT|GAGTCCAGGTCCTAAGATAGTCCAGGTCCT
TATATTCTGGGCCTGCGCGGACGCGTGTAA|ACTATGTTAATACTCTACATTCGTCGCATA
GATAGAGGGACCGCAGGCGTAGTCGAGCAT|TACGCATAGACGCATACCGCCGCATATGGC
CTCGAAGCTGATTCATTGACACTCTGAAAA|GGTGTTCCTAATCAAAGGATTAGAGCGATA
TACCAACGTGCAGCGCGGCTTCTGGCACTA|CCTAAGATAGAGGGACCGCAGGCGCAGGGT
GGCGCGGGGCTTATAGGTCCTACAGAAAAT|AGTCCAGGTCCTAAGATAGAGGGACCGCAG
GAGCATGTTCCCCCAACGGTACACGCTCGA|TATGGCCACGCCCCAAGGATTCGGTGGTGT
GGACCGCAGGGTCTCCTTTTCATCCATGGT|CTTTAAGCCTACCAACGTGCAGCGCGGCTT
ACCAACGTGCAGCGCGGCTTCTGGCACTAT|CTAAGATAGAGGGACCGCAGGCGCAGGGTG
CCAGGTCCTAAGATAGAGGGACCGCAGGTT|TTGACACTCTGAAAAGAGCGACGCACTCCC
GATAGAGGGACCGCAGGCCTTTCTACTAAA|TAGTCGAGCATGTTCCCCCAACGGTACACG
CAGCAAGATTCGTGACAAAGTCGGAGTCCA|GTACCCTATTGCCAGTCAATATATTCTGGG
GGTGATACTACCAGTCCAGGTCCTAAGATA|GATAGAGGGACCGCAGGGTCTCCTTTTCAT
CCGCAGGGTCTCCTTTTCATCCATGGTCAA|TAAGCCTACCAACGTGCAGCGCGGCTTCTG
ACGGTAGGCGTCCCCGGTCCAGGTCCTAAG|CAGGTCCTAAGATAGAGGGACCGCAGGCGT
GTCCAGGTCCTAAGATAGAGGGACCGCAGG|GGGACGGTAGGCGTCCCCGGTCCAGGTCCT
CGCAGGGAGGGACGTCCAGGTCCTAAGATA|CATATGCTGCTTACCAATCGGACGTCCAGG
CGTCGCATATCTCTACTCAACAAGCGAGAG|GTTTCCGCAAATAAATCGGCAGGAGAAACG
CCAAGTACATATGCTGCTTACCAATCGGAC|ACAAGCGAGAGCCCTCCTGGGCCTCAGGCG
GCGTGTAAGGACACTGCGCCAAGTACATAT|GTCGCATATCTCTACTCAACAAGCGAGAGC
GAGGGACGTCCAGGTCCTAAGATAGAGGGA|CTGCTTACCAATCGGACGTCCAGGTCCTAA
ACGCACTCCCCCTAGGTTGCTAGCACAAGT|AAGAGCCGTCTGTTGGTGATACTACCAGTC
TAGAGGGACCGCAGGCGTGGGTACTACGGA|CTACAGAAAATGGTCCAGGTCCTAAGATAG
TCCAGGTCCTAAGATAGTCCAGGTCCTAAG|TGGGCCTGCGCGGACGCGTGTAAGGACACT
GACGCACAACGATACAAATTCCCTGCCTTT|CTAAGATAGTCCAGGTCCTAAGATAGAGGG
GGACGGTAGGCGTCCCCGGTCCAGGTCCTA|TCCAGGTCCTAAGATAGAGGGACCGCAGGC
TAAGATAGAGGGACCGCAGGCCCTGTTGTG|GCGTCCCCGGTCCAGGTCCTAAGATAGAGG
GAGGGACCGCAGGCGCAGGGTGATCCGTGG|TCCTAAGATAGAGGGACCGCAGGCGTGGGT
GATAGAGGGACCGCAGGATGATTAGCACGC|GCTCGCTTCCGTCCACGTACTGCAGATTCT
GCACAAGTGCGATAAAGATGAGACTACGCA|TACCAGTCCAGGTCCTAAGATAGAGGGACC
GATGAGACTACGCATAGACGCATACCGCCG|AAGATAGAGGGACCGCAGGCGGCACGGTCG
AGCCCTCCTGGGCCTCAGGCGCGGGGCTTA|CGGATAGCGATTGTACTAGTCCAGGTCCTA
TCCTAAGATAGAGGGACCGCAGGCGTAGTC|TGAGACTACGCATAGACGCATACCGCCGCA
ACACTGCGCCAAGTACATATGCTGCTTACC|TCTACTCAACAAGCGAGAGCCCTCCTGGGC
TCCAGGTCCTAAGATAGAGGGACCGCAGGC|GGACGGTAGGCGTCCCCGGTCCAGGTCCTA
TACAGAAAATGGTCCAGGTCCTAAGATAGA|GGGACCGCAGGCTATGTGGGCCAGGCTCGC
GAAAATGGTCCAGGTCCTAAGATAGAGGGA|CCGCAGGCTATGTGGGCCAGGCTCGCTTCC
GCCCTGTTGTGTTCAGAATTCTGGGTCGTA|TAAGATAGAGGGACCGCAGGCCTTTCTACT
GGGACCGCAGGAAGATAGAGGGACCGCAGG|GCCTTTCCCACGCTCAGGGACTTTAAGCCT
GTCCTAAGATAGAGGGACCGCAGGCGTGGG|TTATAGGTCCTACAGAAAATGGTCCAGGTC
AGAGGGACCGCAGGGAGGGACGTCCAGGTC|GCCAAGTACATATGCTGCTTACCAATCGGA
ACTATATCCTAGCTCATCAGCAAGATTCGT|GGGTGATCCGTGGGGTCGTACCCTATTGCC
CTAGCACAAGTGCGATAAAGATGAGACTAC|TACTACCAGTCCAGGTCCTAAGATAGAGGG
GGCCACGCCCCAAGGATTCGGTGGTGTTCC|ATCCTTACTACGCGTACCCGACCACTAAGT
CAGGCGGCACGGTCGCAGGTATCCTTACTA|ATGGACTAGGGGTATGGGGACTAGTCCAGG
TAAGATAGAGGGACCGCAGGGACGGTAGGC|AGGGTCTGGTACACCACCGTCCAGGTCCTA
GCAGGTATCCTTACTACGCGTACCCGACCA|TGGGGACTAGTCCAGGTCCTAAGATAGAGG
GGTGATCCGTGGGGTCGTACCCTATTGCCA|GCAGGCGTGGGTACTACGGAGCAAGCCGTA
AAGAGCGACGCACTCCCCCTAGGTTGCTAG|TAGGCTTAAGAGCCGTCTGTTGGTGATACT
GGCCTGCGCGGACGCGTGTAAGGACACTGC|ATACTCTACATTCGTCGCATATCTCTACTC
GTCCAGGTCCTAAGATAGAGGGACCGCAGG|GGGACCGCAGGCGTAGTCGAGCATGTTCCC
AGGGGTATGGGGACTAGTCCAGGTCCTAAG|TATCCTAGCTCATCAGCAAGATTCGTGACA
CCTAAGATAGAGGGACCGCAGGATGATTAG|GCCAGGCTCGCTTCCGTCCACGTACTGCAG
GCGGCTTCTGGCACTATATCCTAGCTCATC|ACCGCAGGCGCAGGGTGATCCGTGGGGTCG
CAGGCCTTTCTACTAAACCACAGAACTAAA|TCCCCCAACGGTACACGCTCGAAGCTGATT
GCGGGGCTTATAGGTCCTACAGAAAATGGT|CCAGGTCCTAAGATAGAGGGACCGCAGGCT
TAGAGGGACCGCAGGCGTAGTCGAGCATGT|CGCATAGACGCATACCGCCGCATATGGCCA
TATTCTGGGCCTGCGCGGACGCGTGTAAGG|TATGTTAATACTCTACATTCGTCGCATATC
CATACCGCCGCATATGGCCACGCCCCAAGG|GGCACGGTCGCAGGTATCCTTACTACGCGT
ACACTCTGAAAAGAGCGACGCACTCCCCCT|ATTAGAGCGATAGGCTTAAGAGCCGTCTGT
ATAGAGGGACCGCAGGCGTAGTCGAGCATG|ACGCATAGACGCATACCGCCGCATATGGCC
CCCTAGGTTGCTAGCACAAGTGCGATAAAG|CTGTTGGTGATACTACCAGTCCAGGTCCTA
CGTCCAGGTCCTAAGATAGAGGGACCGCAG|GATAAAGATGAGACTACGCATAGACGCATA
ATGTTCCCCCAACGGTACACGCTCGAAGCT|GCCACGCCCCAAGGATTCGGTGGTGTTCCT
CAAATTCCCTGCCTTTCCCACGCTCAGGGA|GTCCTAAGATAGAGGGACCGCAGGGAGGGA
ATTCTGGGTCGTATTTCTTTAATTCTGATG|AGGCCTTTCTACTAAACCACAGAACTAAAG
GACTTTAAGCCTACCAACGTGCAGCGCGGC|GACGTCCAGGTCCTAAGATAGAGGGACCGC
GAGGGACCGCAGGTTAAACAAGGGTCTGGT|GAGCGACGCACTCCCCCTAGGTTGCTAGCA
CAGAAAATGGTCCAGGTCCTAAGATAGAGG|GACCGCAGGCTATGTGGGCCAGGCTCGCTT
CGCCAAGTACATATGCTGCTTACCAATCGG|CAACAAGCGAGAGCCCTCCTGGGCCTCAGG
AGGTCCTAAGATAGAGGGACCGCAGGAGAC|ATTCGTGACAAAGTCGGAGTCCAGGTCCTA
GGACGTCCAGGTCCTAAGATAGAGGGACCG|CTTACCAATCGGACGTCCAGGTCCTAAGAT
TAAGATAGAGGGACCGCAGGCGGCACGGTC|TTTTCATCCATGGTCAATGGACTAGGGGTA
GTAAGCCTACTATGTTAATACTCTACATTC|GCAGGATGATTAGCACGCACCCCAGGCTTG
AGGGACCGCAGGAAGATAGAGGGACCGCAG|TGCCTTTCCCACGCTCAGGGACTTTAAGCC
GGGCTTATAGGTCCTACAGAAAATGGTCCA|GGTCCTAAGATAGAGGGACCGCAGGCTATG
TCCTAAGATAGAGGGACCGCAGGAGACGCA|CGTGACAAAGTCGGAGTCCAGGTCCTAAGA
GGTCAATGGACTAGGGGTATGGGGACTAGT|CTTCTGGCACTATATCCTAGCTCATCAGCA
GGGACCGCAGGCCCTGTTGTGTTCAGAATT|GTCCAGGTCCTAAGATAGAGGGACCGCAGG
CATCCATGGTCAATGGACTAGGGGTATGGG|AGCGCGGCTTCTGGCACTATATCCTAGCTC
TCTCTACTCAACAAGCGAGAGCCCTCCTGG|AATAAATCGGCAGGAGAAACGGATAGCGAT
AGAGCGATAGGCTTAAGAGCCGTCTGTTGG|AGGTCCTAAGATAGAGGGACCGCAGGAAGA
TCTACATTCGTCGCATATCTCTACTCAACA|CCAGGCTTGTTTCCGCAAATAAATCGGCAG
CAGGTCCTAAGATAGAGGGACCGCAGGCGC|ATCGGACGTCCAGGTCCTAAGATAGAGGGA
TATATCCTAGCTCATCAGCAAGATTCGTGA|GTGATCCGTGGGGTCGTACCCTATTGCCAG
ATTCGTGACAAAGTCGGAGTCCAGGTCCTA|ATTGCCAGTCAATATATTCTGGGCCTGCGC
ACTGCGCCAAGTACATATGCTGCTTACCAA|TACTCAACAAGCGAGAGCCCTCCTGGGCCT
CTCCCCCTAGGTTGCTAGCACAAGTGCGAT|CCGTCTGTTGGTGATACTACCAGTCCAGGT
ACATATGCTGCTTACCAATCGGACGTCCAG|GAGAGCCCTCCTGGGCCTCAGGCGCGGGGC
GTCCTACAGAAAATGGTCCAGGTCCTAAGA|TAGAGGGACCGCAGGCTATGTGGGCCAGGC
CTCAGGGACTTTAAGCCTACCAACGTGCAG|GGGAGGGACGTCCAGGTCCTAAGATAGAGG
TAAGATAGAGGGACCGCAGGCCTTTCTACT|GCGTAGTCGAGCATGTTCCCCCAACGGTAC
CAAAGTCGGAGTCCAGGTCCTAAGATAGTC|TCAATATATTCTGGGCCTGCGCGGACGCGT
ACCCCAGGCTTGTTTCCGCAAATAAATCGG|TCATTGTATGATCATCCGGGCGGTCGACTA
GTCCAGGTCCTAAGATAGAGGGACCGCAGG|ACAACGATACAAATTCCCTGCCTTTCCCAC
GGACCGCAGGGAGGGACGTCCAGGTCCTAA|AGTACATATGCTGCTTACCAATCGGACGTC
CGCAGGCGGCACGGTCGCAGGTATCCTTAC|CAATGGACTAGGGGTATGGGGACTAGTCCA
ACAACGATACAAATTCCCTGCCTTTCCCAC|ATAGTCCAGGTCCTAAGATAGAGGGACCGC
GCCAGTCAATATATTCTGGGCCTGCGCGGA|CGTAAGCCTACTATGTTAATACTCTACATT
GCCCCAAGGATTCGGTGGTGTTCCTAATCA|ACTACGCGTACCCGACCACTAAGTCCAGGT
TCGAGCATGTTCCCCCAACGGTACACGCTC|CATATGGCCACGCCCCAAGGATTCGGTGGT
AGGGACCGCAGGCGCAGGGTGATCCGTGGG|CCTAAGATAGAGGGACCGCAGGCGTGGGTA
AAGATAGAGGGACCGCAGGGTCTCCTTTTC|GCTCAGGGACTTTAAGCCTACCAACGTGCA
GCAGGGAGGGACGTCCAGGTCCTAAGATAG|ATATGCTGCTTACCAATCGGACGTCCAGGT
ATAGAGGGACCGCAGGCGGCACGGTCGCAG|CATCCATGGTCAATGGACTAGGGGTATGGG
AAGATAGAGGGACCGCAGGATGATTAGCAC|AGGCTCGCTTCCGTCCACGTACTGCAGATT
TCTGGGCCTGCGCGGACGCGTGTAAGGACA|GTTAATACTCTACATTCGTCGCATATCTCT
GTGGTGTTCCTAATCAAAGGATTAGAGCGA|ACCACTAAGTCCAGGTCCTGTCCAGGTCCT
GACCGCAGGGAGGGACGTCCAGGTCCTAAG|GTACATATGCTGCTTACCAATCGGACGTCC
CGCTCGAAGCTGATTCATTGACACTCTGAA|GTGGTGTTCCTAATCAAAGGATTAGAGCGA
CTAAGATAGAGGGACCGCAGGGAGGGACGT|ACACTGCGCCAAGTACATATGCTGCTTACC
ACGATACAAATTCCCTGCCTTTCCCACGCT|GTCCAGGTCCTAAGATAGAGGGACCGCAGG
GTCCTAAGATAGAGGGACCGCAGGGAGGGA|AGGACACTGCGCCAAGTACATATGCTGCTT
AAGGACACTGCGCCAAGTACATATGCTGCT|TATCTCTACTCAACAAGCGAGAGCCCTCCT
AGGGACCGCAGGCGGCACGGTCGCAGGTAT|CATGGTCAATGGACTAGGGGTATGGGGACT
CGTGTGGTCCAGGTCCTAAGATAGAGGGAC|ACCGCAGGGACGGTAGGCGTCCCCGGTCCA
AGAAAATGGTCCAGGTCCTAAGATAGAGGG|ACCGCAGGCTATGTGGGCCAGGCTCGCTTC
TCAATATATTCTGGGCCTGCGCGGACGCGT|GCCTACTATGTTAATACTCTACATTCGTCG
AACGATACAAATTCCCTGCCTTTCCCACGC|AGTCCAGGTCCTAAGATAGAGGGACCGCAG
TTGCTAGCACAAGTGCGATAAAGATGAGAC|TGATACTACCAGTCCAGGTCCTAAGATAGA
TGGCACTATATCCTAGCTCATCAGCAAGAT|CGCAGGGTGATCCGTGGGGTCGTACCCTAT
AGAGGGACCGCAGGCGTGGGTACTACGGAG|TACAGAAAATGGTCCAGGTCCTAAGATAGA
TACCAATCGGACGTCCAGGTCCTAAGATAG|GGGCCTCAGGCGCGGGGCTTATAGGTCCTA
CTAAGATAGAGGGACCGCAGGCCCTGTTGT|GGCGTCCCCGGTCCAGGTCCTAAGATAGAG
AATCAAAGGATTAGAGCGATAGGCTTAAGA|CAGGTCCTGTCCAGGTCCTAAGATAGAGGG
CAAGTACATATGCTGCTTACCAATCGGACG|CAAGCGAGAGCCCTCCTGGGCCTCAGGCGC
ACTAGTCCAGGTCCTAAGATAGAGGGACCG|TCAGCAAGATTCGTGACAAAGTCGGAGTCC
ATCCATGGTCAATGGACTAGGGGTATGGGG|GCGCGGCTTCTGGCACTATATCCTAGCTCA
GATTCGGTGGTGTTCCTAATCAAAGGATTA|TACCCGACCACTAAGTCCAGGTCCTGTCCA
CTACGCGTACCCGACCACTAAGTCCAGGTC|AGGTCCTAAGATAGAGGGACCGCAGGAGAC
CGCAGGCCTTTCTACTAAACCACAGAACTA|GTTCCCCCAACGGTACACGCTCGAAGCTGA
AGCAAGCCGTAAGCCTACTATGTTAATACT|GAGGGACCGCAGGATGATTAGCACGCACCC
CATTTCAGAGGGCCGTATTTAAAGTCCAGG|AGGTCCTAAGATAGAGGGACCGCAGGTTAA
ATAGTCCAGGTCCTAAGATAGAGGGACCGC|ACGCGTGTAAGGACACTGCGCCAAGTACAT
GCGTCCCCGGTCCAGGTCCTAAGATAGAGG|TAAGATAGAGGGACCGCAGGCGTAGTCGAG
ACCACAGAACTAAAGTCCAGGTCCTAAGAT|GCTCGAAGCTGATTCATTGACACTCTGAAA
GCCTTTCTACTAAACCACAGAACTAAAGTC|CCCAACGGTACACGCTCGAAGCTGATTCAT
GTGATACTACCAGTCCAGGTCCTAAGATAG|ATAGAGGGACCGCAGGGTCTCCTTTTCATC
CGGACGCGTGTAAGGACACTGCGCCAAGTA|CATTCGTCGCATATCTCTACTCAACAAGCG
CGCAGGTATCCTTACTACGCGTACCCGACC|ATGGGGACTAGTCCAGGTCCTAAGATAGAG
CGCATAGACGCATACCGCCGCATATGGCCA|GACCGCAGGCGGCACGGTCGCAGGTATCCT
CGATACAAATTCCCTGCCTTTCCCACGCTC|TCCAGGTCCTAAGATAGAGGGACCGCAGGG
GACCGCAGGAAGATAGAGGGACCGCAGGGT|CTTTCCCACGCTCAGGGACTTTAAGCCTAC
CCGTCTGTTGGTGATACTACCAGTCCAGGT|CCGCAGGAAGATAGAGGGACCGCAGGGTCT
CCTGCGCGGACGCGTGTAAGGACACTGCGC|ACTCTACATTCGTCGCATATCTCTACTCAA
TGCGCGGACGCGTGTAAGGACACTGCGCCA|TCTACATTCGTCGCATATCTCTACTCAACA
GGCGTGGGTACTACGGAGCAAGCCGTAAGC|TCCAGGTCCTAAGATAGAGGGACCGCAGGA
ACCGTCCAGGTCCTAAGATAGAGGGACCGC|GCGATAAAGATGAGACTACGCATAGACGCA
GACCGCAGGCGTGGGTACTACGGAGCAAGC|AAAATGGTCCAGGTCCTAAGATAGAGGGAC
GGGACCGCAGGAGACGCACAACGATACAAA|GGAGTCCAGGTCCTAAGATAGTCCAGGTCC
AGGGACCGCAGGCCTTTCTACTAAACCACA|GAGCATGTTCCCCCAACGGTACACGCTCGA
TACTACCAGTCCAGGTCCTAAGATAGAGGG|AGGGACCGCAGGGTCTCCTTTTCATCCATG
AAGATAGAGGGACCGCAGGAGACGCACAAC|ACAAAGTCGGAGTCCAGGTCCTAAGATAGT
GGTCCTAAGATAGAGGGACCGCAGGAAGAT|GATACAAATTCCCTGCCTTTCCCACGCTCA
ATGCTGCTTACCAATCGGACGTCCAGGTCC|GCCCTCCTGGGCCTCAGGCGCGGGGCTTAT
AAGTCCAGGTCCTAAGATAGAGGGACCGCA|TTCATTGACACTCTGAAAAGAGCGACGCAC
AGCACAAGTGCGATAAAGATGAGACTACGC|CTACCAGTCCAGGTCCTAAGATAGAGGGAC
GTGCGATAAAGATGAGACTACGCATAGACG|TCCAGGTCCTAAGATAGAGGGACCGCAGGC
CTACAGAAAATGGTCCAGGTCCTAAGATAG|AGGGACCGCAGGCTATGTGGGCCAGGCTCG
CGGTCGCAGGTATCCTTACTACGCGTACCC|GGGTATGGGGACTAGTCCAGGTCCTAAGAT
CGACCACTAAGTCCAGGTCCTGTCCAGGTC|TAGAGGGACCGCAGGAGACGCACAACGATA
ACCACTAAGTCCAGGTCCTGTCCAGGTCCT|GAGGGACCGCAGGAGACGCACAACGATACA
CCCCAAGGATTCGGTGGTGTTCCTAATCAA|CTACGCGTACCCGACCACTAAGTCCAGGTC
AGATAGAGGGACCGCAGGCCCTGTTGTGTT|GTCCCCGGTCCAGGTCCTAAGATAGAGGGA
TTCCCACGCTCAGGGACTTTAAGCCTACCA|GGACCGCAGGGAGGGACGTCCAGGTCCTAA
TCCAGGTCCTAAGATAGAGGGACCGCAGGA|TATGTGGGCCAGGCTCGCTTCCGTCCACGT
CAGGTCCTAAGATAGAGGGACCGCAGGCGG|GGTCTCCTTTTCATCCATGGTCAATGGACT
TATGGGGACTAGTCCAGGTCCTAAGATAGA|TAGCTCATCAGCAAGATTCGTGACAAAGTC
TACCCGACCACTAAGTCCAGGTCCTGTCCA|AAGATAGAGGGACCGCAGGAGACGCACAAC
GACTACGCATAGACGCATACCGCCGCATAT|AGAGGGACCGCAGGCGGCACGGTCGCAGGT
TAAGCCTACCAACGTGCAGCGCGGCTTCTG|CCAGGTCCTAAGATAGAGGGACCGCAGGCG
GATAGAGGGACCGCAGGGTCTCCTTTTCAT|TCAGGGACTTTAAGCCTACCAACGTGCAGC
TAGAGGGACCGCAGGCCCTGTTGTGTTCAG|CCCGGTCCAGGTCCTAAGATAGAGGGACCG
GAGCCGTCTGTTGGTGATACTACCAGTCCA|GGACCGCAGGAAGATAGAGGGACCGCAGGG
ACCAATCGGACGTCCAGGTCCTAAGATAGA|GGCCTCAGGCGCGGGGCTTATAGGTCCTAC
TCCCGTACGTGTGGTCCAGGTCCTAAGATA|TAGAGGGACCGCAGGGACGGTAGGCGTCCC
GGGACCGCAGGGACGGTAGGCGTCCCCGGT|TACACCACCGTCCAGGTCCTAAGATAGAGG
AGGGACGTCCAGGTCCTAAGATAGAGGGAC|TGCTTACCAATCGGACGTCCAGGTCCTAAG
GGCGTAGTCGAGCATGTTCCCCCAACGGTA|ACCGCCGCATATGGCCACGCCCCAAGGATT
AGGAGACGCACAACGATACAAATTCCCTGC|GGTCCTAAGATAGTCCAGGTCCTAAGATAG
CGCAGGAGACGCACAACGATACAAATTCCC|CCAGGTCCTAAGATAGTCCAGGTCCTAAGA
TGGCCACGCCCCAAGGATTCGGTGGTGTTC|TATCCTTACTACGCGTACCCGACCACTAAG
AGGTCCTAAGATAGAGGGACCGCAGGATGA|GTGGGCCAGGCTCGCTTCCGTCCACGTACT
AGGCGGCACGGTCGCAGGTATCCTTACTAC|TGGACTAGGGGTATGGGGACTAGTCCAGGT
AGGTCCTAAGATAGAGGGACCGCAGGCGGC|GTCTCCTTTTCATCCATGGTCAATGGACTA
GACACTCTGAAAAGAGCGACGCACTCCCCC|GATTAGAGCGATAGGCTTAAGAGCCGTCTG
TACTAAACCACAGAACTAAAGTCCAGGTCC|GTACACGCTCGAAGCTGATTCATTGACACT
AGGGACCGCAGGATGATTAGCACGCACCCC|CTTCCGTCCACGTACTGCAGATTCTTCATT
CCGCAGGCCCTGTTGTGTTCAGAATTCTGG|AGGTCCTAAGATAGAGGGACCGCAGGCCTT
GCGATAAAGATGAGACTACGCATAGACGCA|CAGGTCCTAAGATAGAGGGACCGCAGGCGG
GATAGAGGGACCGCAGGCGGCACGGTCGCA|TCATCCATGGTCAATGGACTAGGGGTATGG
CAAGCCGTAAGCCTACTATGTTAATACTCT|GGGACCGCAGGATGATTAGCACGCACCCCA
AGGTATCCTTACTACGCGTACCCGACCACT|GGGACTAGTCCAGGTCCTAAGATAGAGGGA
GGGTGATCCGTGGGGTCGTACCCTATTGCC|CGCAGGCGTGGGTACTACGGAGCAAGCCGT
TACACCACCGTCCAGGTCCTAAGATAGAGG|ACAAGTGCGATAAAGATGAGACTACGCATA
TACTATGTTAATACTCTACATTCGTCGCAT|GATTAGCACGCACCCCAGGCTTGTTTCCGC
GGACCGCAGGATGATTAGCACGCACCCCAG|TCCGTCCACGTACTGCAGATTCTTCATTGT
CAAGCGAGAGCCCTCCTGGGCCTCAGGCGC|AGGAGAAACGGATAGCGATTGTACTAGTCC
TAGAGGGACCGCAGGAAGATAGAGGGACCG|CCCTGCCTTTCCCACGCTCAGGGACTTTAA
AGGGACTTTAAGCCTACCAACGTGCAGCGC|AGGGACGTCCAGGTCCTAAGATAGAGGGAC
ACAAATTCCCTGCCTTTCCCACGCTCAGGG|GGTCCTAAGATAGAGGGACCGCAGGGAGGG
AGGTCCTAAGATAGAGGGACCGCAGGCCCT|CGGTAGGCGTCCCCGGTCCAGGTCCTAAGA
AGGTTGCTAGCACAAGTGCGATAAAGATGA|TGGTGATACTACCAGTCCAGGTCCTAAGAT
GCATATGGCCACGCCCCAAGGATTCGGTGG|GCAGGTATCCTTACTACGCGTACCCGACCA
CCCCAACGGTACACGCTCGAAGCTGATTCA|CCCCAAGGATTCGGTGGTGTTCCTAATCAA
GGTCTCCTTTTCATCCATGGTCAATGGACT|TACCAACGTGCAGCGCGGCTTCTGGCACTA
AAGGATTAGAGCGATAGGCTTAAGAGCCGT|CCTGTCCAGGTCCTAAGATAGAGGGACCGC
GCGACGCACTCCCCCTAGGTTGCTAGCACA|CTTAAGAGCCGTCTGTTGGTGATACTACCA
TTCCCTGCCTTTCCCACGCTCAGGGACTTT|TAAGATAGAGGGACCGCAGGGAGGGACGTC
GCTTCATTTCAGAGGGCCGTATTTAAAGTC|GTCCAGGTCCTAAGATAGAGGGACCGCAGG
CCGCAGGCCCCTGTGTTCCCGTACGTGTGG|AGTCCAGGTCCTAAGATAGAGGGACCGCAG
CCGCAGGATGATTAGCACGCACCCCAGGCT|GTCCACGTACTGCAGATTCTTCATTGTATG
GAGGGACCGCAGGCGTAGTCGAGCATGTTC|CATAGACGCATACCGCCGCATATGGCCACG
CCCCCAACGGTACACGCTCGAAGCTGATTC|GCCCCAAGGATTCGGTGGTGTTCCTAATCA
GGTTGCTAGCACAAGTGCGATAAAGATGAG|GGTGATACTACCAGTCCAGGTCCTAAGATA
TGCCAGTCAATATATTCTGGGCCTGCGCGG|CCGTAAGCCTACTATGTTAATACTCTACAT
AGGGACGGTAGGCGTCCCCGGTCCAGGTCC|CGTCCAGGTCCTAAGATAGAGGGACCGCAG
GCCTGCGCGGACGCGTGTAAGGACACTGCG|TACTCTACATTCGTCGCATATCTCTACTCA
ATAGACGCATACCGCCGCATATGGCCACGC|CGCAGGCGGCACGGTCGCAGGTATCCTTAC
CCCTGCCTTTCCCACGCTCAGGGACTTTAA|AGATAGAGGGACCGCAGGGAGGGACGTCCA
ACTCCCCCTAGGTTGCTAGCACAAGTGCGA|GCCGTCTGTTGGTGATACTACCAGTCCAGG
TAAGATAGAGGGACCGCAGGGAGGGACGTC|CACTGCGCCAAGTACATATGCTGCTTACCA
GATACAAATTCCCTGCCTTTCCCACGCTCA|CCAGGTCCTAAGATAGAGGGACCGCAGGGA
ACGCCCCAAGGATTCGGTGGTGTTCCTAAT|TTACTACGCGTACCCGACCACTAAGTCCAG
CAGGGACTTTAAGCCTACCAACGTGCAGCG|GAGGGACGTCCAGGTCCTAAGATAGAGGGA
ACTATGTTAATACTCTACATTCGTCGCATA|ATTAGCACGCACCCCAGGCTTGTTTCCGCA
GGACGCGTGTAAGGACACTGCGCCAAGTAC|ATTCGTCGCATATCTCTACTCAACAAGCGA
GGGACCGCAGGTTAAACAAGGGTCTGGTAC|GCGACGCACTCCCCCTAGGTTGCTAGCACA
TGGGCCTGCGCGGACGCGTGTAAGGACACT|TAATACTCTACATTCGTCGCATATCTCTAC
CCTAGCTCATCAGCAAGATTCGTGACAAAG|CCGTGGGGTCGTACCCTATTGCCAGTCAAT
TCCTAAGATAGAGGGACCGCAGGGACGGTA|ACAAGGGTCTGGTACACCACCGTCCAGGTC
TCCTGTCCAGGTCCTAAGATAGAGGGACCG|ACGCACAACGATACAAATTCCCTGCCTTTC
AAGTCGGAGTCCAGGTCCTAAGATAGTCCA|AATATATTCTGGGCCTGCGCGGACGCGTGT
GTATGGGGACTAGTCCAGGTCCTAAGATAG|CTAGCTCATCAGCAAGATTCGTGACAAAGT
GCCGTATTTAAAGTCCAGGTCCTAAGATAG|TAGAGGGACCGCAGGTTAAACAAGGGTCTG
GCACGCACCCCAGGCTTGTTTCCGCAAATA|GATTCTTCATTGTATGATCATCCGGGCGGT
GTGTTCAGAATTCTGGGTCGTATTTCTTTA|AGGGACCGCAGGCCTTTCTACTAAACCACA
CTAGGTTGCTAGCACAAGTGCGATAAAGAT|GTTGGTGATACTACCAGTCCAGGTCCTAAG
CAGGTCCTAAGATAGAGGGACCGCAGGCCC|ACGGTAGGCGTCCCCGGTCCAGGTCCTAAG
AGGAAGATAGAGGGACCGCAGGGTCTCCTT|CACGCTCAGGGACTTTAAGCCTACCAACGT
TGTTCAGAATTCTGGGTCGTATTTCTTTAA|GGGACCGCAGGCCTTTCTACTAAACCACAG
GGTCCAGGTCCTAAGATAGAGGGACCGCAG|GCTATGTGGGCCAGGCTCGCTTCCGTCCAC
AGAGGGACCGCAGGCCCTGTTGTGTTCAGA|CCGGTCCAGGTCCTAAGATAGAGGGACCGC
TCTCCTTTTCATCCATGGTCAATGGACTAG|CCAACGTGCAGCGCGGCTTCTGGCACTATA
CTGTTGGTGATACTACCAGTCCAGGTCCTA|AGGAAGATAGAGGGACCGCAGGGTCTCCTT
AGCGCGGCTTCTGGCACTATATCCTAGCTC|GGGACCGCAGGCGCAGGGTGATCCGTGGGG
GACGCATACCGCCGCATATGGCCACGCCCC|AGGCGGCACGGTCGCAGGTATCCTTACTAC
CGTGTAAGGACACTGCGCCAAGTACATATG|TCGCATATCTCTACTCAACAAGCGAGAGCC
AGTCCAGGTCCTAAGATAGTCCAGGTCCTA|TCTGGGCCTGCGCGGACGCGTGTAAGGACA
CCCCGCAGGCCCCTGTGTTCCCGTACGTGT|AAAGTCCAGGTCCTAAGATAGAGGGACCGC
TCAGAGGGCCGTATTTAAAGTCCAGGTCCT|CCTAAGATAGAGGGACCGCAGGTTAAACAA
CAGGTCCTAAGATAGAGGGACCGCAGGGAG|GTAAGGACACTGCGCCAAGTACATATGCTG
AAACCACAGAACTAAAGTCCAGGTCCTAAG|ACGCTCGAAGCTGATTCATTGACACTCTGA
GAATTCTGGGTCGTATTTCTTTAATTCTGA|GCAGGCCTTTCTACTAAACCACAGAACTAA
ACGTGCAGCGCGGCTTCTGGCACTATATCC|GATAGAGGGACCGCAGGCGCAGGGTGATCC
CCACCGTCCAGGTCCTAAGATAGAGGGACC|GTGCGATAAAGATGAGACTACGCATAGACG
AAACAAGGGTCTGGTACACCACCGTCCAGG|CCTAGGTTGCTAGCACAAGTGCGATAAAGA
CCTAAGATAGAGGGACCGCAGGAGACGCAC|GTGACAAAGTCGGAGTCCAGGTCCTAAGAT
AGGGAGGGACGTCCAGGTCCTAAGATAGAG|ATGCTGCTTACCAATCGGACGTCCAGGTCC
TGGTCCAGGTCCTAAGATAGAGGGACCGCA|CAGGGACGGTAGGCGTCCCCGGTCCAGGTC
ATACTACCAGTCCAGGTCCTAAGATAGAGG|GAGGGACCGCAGGGTCTCCTTTTCATCCAT
AATCGGACGTCCAGGTCCTAAGATAGAGGG|CTCAGGCGCGGGGCTTATAGGTCCTACAGA
GGACCGCAGGTTAAACAAGGGTCTGGTACA|CGACGCACTCCCCCTAGGTTGCTAGCACAA
CGTACCCGACCACTAAGTCCAGGTCCTGTC|CTAAGATAGAGGGACCGCAGGAGACGCACA
CAGTCCAGGTCCTAAGATAGAGGGACCGCA|CGCAGGGTCTCCTTTTCATCCATGGTCAAT
GCGCGGACGCGTGTAAGGACACTGCGCCAA|CTACATTCGTCGCATATCTCTACTCAACAA
GGATTAGAGCGATAGGCTTAAGAGCCGTCT|TGTCCAGGTCCTAAGATAGAGGGACCGCAG
TGGGGACTAGTCCAGGTCCTAAGATAGAGG|GCTCATCAGCAAGATTCGTGACAAAGTCGG
GCTTAAGAGCCGTCTGTTGGTGATACTACC|ATAGAGGGACCGCAGGAAGATAGAGGGACC
GGACCGCAGGCCTTTCTACTAAACCACAGA|GCATGTTCCCCCAACGGTACACGCTCGAAG
GTTCCCCCAACGGTACACGCTCGAAGCTGA|CACGCCCCAAGGATTCGGTGGTGTTCCTAA
AGGTCCTACAGAAAATGGTCCAGGTCCTAA|GATAGAGGGACCGCAGGCTATGTGGGCCAG
ATTCGGTGGTGTTCCTAATCAAAGGATTAG|ACCCGACCACTAAGTCCAGGTCCTGTCCAG
TAAAGTCCAGGTCCTAAGATAGAGGGACCG|CCGCAGGTTAAACAAGGGTCTGGTACACCA
CTCTACTCAACAAGCGAGAGCCCTCCTGGG|ATAAATCGGCAGGAGAAACGGATAGCGATT
AGTCCAGGTCCTAAGATAGAGGGACCGCAG|GCAGGGTCTCCTTTTCATCCATGGTCAATG
GGTCCTAAGATAGAGGGACCGCAGGCCCTG|GGTAGGCGTCCCCGGTCCAGGTCCTAAGAT
AGGCGTAGTCGAGCATGTTCCCCCAACGGT|TACCGCCGCATATGGCCACGCCCCAAGGAT
CCAGGTCCTAAGATAGAGGGACCGCAGGCC|GACGGTAGGCGTCCCCGGTCCAGGTCCTAA
TCCCCCAACGGTACACGCTCGAAGCTGATT|CGCCCCAAGGATTCGGTGGTGTTCCTAATC
CACCACCGTCCAGGTCCTAAGATAGAGGGA|AAGTGCGATAAAGATGAGACTACGCATAGA
GGTACACGCTCGAAGCTGATTCATTGACAC|GATTCGGTGGTGTTCCTAATCAAAGGATTA
AGGATTCGGTGGTGTTCCTAATCAAAGGAT|CGTACCCGACCACTAAGTCCAGGTCCTGTC
CACGCCCCAAGGATTCGGTGGTGTTCCTAA|CTTACTACGCGTACCCGACCACTAAGTCCA
TGGGTCGTATTTCTTTAATTCTGATGCTTC|CTTTCTACTAAACCACAGAACTAAAGTCCA
TTTCATCCATGGTCAATGGACTAGGGGTAT|TGCAGCGCGGCTTCTGGCACTATATCCTAG
CAGAGGGCCGTATTTAAAGTCCAGGTCCTA|CTAAGATAGAGGGACCGCAGGTTAAACAAG
CCAGGTCCTAAGATAGAGGGACCGCAGGAT|ATGTGGGCCAGGCTCGCTTCCGTCCACGTA
GATAGAGGGACCGCAGGCCCTGTTGTGTTC|TCCCCGGTCCAGGTCCTAAGATAGAGGGAC
ATCCTAGCTCATCAGCAAGATTCGTGACAA|ATCCGTGGGGTCGTACCCTATTGCCAGTCA
AGGATTAGAGCGATAGGCTTAAGAGCCGTC|CTGTCCAGGTCCTAAGATAGAGGGACCGCA
CAGGAGACGCACAACGATACAAATTCCCTG|AGGTCCTAAGATAGTCCAGGTCCTAAGATA
GTAGGCGTCCCCGGTCCAGGTCCTAAGATA|GTCCTAAGATAGAGGGACCGCAGGCGTAGT
GAGCGATAGGCTTAAGAGCCGTCTGTTGGT|GGTCCTAAGATAGAGGGACCGCAGGAAGAT
CCAGGTCCTAAGATAGAGGGACCGCAGGCG|AATCGGACGTCCAGGTCCTAAGATAGAGGG
CACGCTCAGGGACTTTAAGCCTACCAACGT|CGCAGGGAGGGACGTCCAGGTCCTAAGATA
AGAGGGACCGCAGGGACGGTAGGCGTCCCC|TGGTACACCACCGTCCAGGTCCTAAGATAG
CAGTCAATATATTCTGGGCCTGCGCGGACG|TAAGCCTACTATGTTAATACTCTACATTCG
CAAAGGATTAGAGCGATAGGCTTAAGAGCC|GTCCTGTCCAGGTCCTAAGATAGAGGGACC
GGTATGGGGACTAGTCCAGGTCCTAAGATA|CCTAGCTCATCAGCAAGATTCGTGACAAAG
TTCATTTCAGAGGGCCGTATTTAAAGTCCA|CCAGGTCCTAAGATAGAGGGACCGCAGGTT
AGGCCCTGTTGTGTTCAGAATTCTGGGTCG|CCTAAGATAGAGGGACCGCAGGCCTTTCTA
CTGATGCTTCATTTCAGAGGGCCGTATTTA|CTAAAGTCCAGGTCCTAAGATAGAGGGACC
AGGTCCTAAGATAGAGGGACCGCAGGTTAA|GACACTCTGAAAAGAGCGACGCACTCCCCC
AAGTGCGATAAAGATGAGACTACGCATAGA|AGTCCAGGTCCTAAGATAGAGGGACCGCAG
TTCTTTAATTCTGATGCTTCATTTCAGAGG|AACCACAGAACTAAAGTCCAGGTCCTAAGA
AGCACGCACCCCAGGCTTGTTTCCGCAAAT|AGATTCTTCATTGTATGATCATCCGGGCGG
GGGACTTTAAGCCTACCAACGTGCAGCGCG|GGGACGTCCAGGTCCTAAGATAGAGGGACC
AGGTCCTAAGATAGAGGGACCGCAGGCGTG|GCTTATAGGTCCTACAGAAAATGGTCCAGG
ACCGCAGGTTAAACAAGGGTCTGGTACACC|ACGCACTCCCCCTAGGTTGCTAGCACAAGT
TACTCTACATTCGTCGCATATCTCTACTCA|ACCCCAGGCTTGTTTCCGCAAATAAATCGG
ATTTAAAGTCCAGGTCCTAAGATAGAGGGA|GGACCGCAGGTTAAACAAGGGTCTGGTACA
CATTGACACTCTGAAAAGAGCGACGCACTC|AAAGGATTAGAGCGATAGGCTTAAGAGCCG
TCCTAAGATAGTCCAGGTCCTAAGATAGAG|TGCGCGGACGCGTGTAAGGACACTGCGCCA
GTGGGGTCGTACCCTATTGCCAGTCAATAT|GGGTACTACGGAGCAAGCCGTAAGCCTACT
GCATACCGCCGCATATGGCCACGCCCCAAG|CGGCACGGTCGCAGGTATCCTTACTACGCG
GAGAGCCCTCCTGGGCCTCAGGCGCGGGGC|AAACGGATAGCGATTGTACTAGTCCAGGTC
ATAGGTCCTACAGAAAATGGTCCAGGTCCT|AAGATAGAGGGACCGCAGGCTATGTGGGCC
GCTCAGGGACTTTAAGCCTACCAACGTGCA|AGGGAGGGACGTCCAGGTCCTAAGATAGAG
AGATAGAGGGACCGCAGGAAGATAGAGGGA|ATTCCCTGCCTTTCCCACGCTCAGGGACTT
GTCCTAAGATAGAGGGACCGCAGGAAGATA|ATACAAATTCCCTGCCTTTCCCACGCTCAG
TGTGTTCAGAATTCTGGGTCGTATTTCTTT|GAGGGACCGCAGGCCTTTCTACTAAACCAC
GTAGTCGAGCATGTTCCCCCAACGGTACAC|GCCGCATATGGCCACGCCCCAAGGATTCGG
CCTAAGATAGAGGGACCGCAGGCCTTTCTA|AGGCGTAGTCGAGCATGTTCCCCCAACGGT
CCAGGTCCTAAGATAGAGGGACCGCAGGCG|GGGTCTCCTTTTCATCCATGGTCAATGGAC
GGACCGCAGGCCCTGTTGTGTTCAGAATTC|TCCAGGTCCTAAGATAGAGGGACCGCAGGC
AGAGGGACCGCAGGCGCAGGGTGATCCGTG|GTCCTAAGATAGAGGGACCGCAGGCGTGGG
CGCCGCATATGGCCACGCCCCAAGGATTCG|GGTCGCAGGTATCCTTACTACGCGTACCCG
CTAAGATAGAGGGACCGCAGGAAGATAGAG|CAAATTCCCTGCCTTTCCCACGCTCAGGGA
GTCGCATATCTCTACTCAACAAGCGAGAGC|TTTCCGCAAATAAATCGGCAGGAGAAACGG
CTGTGTTCCCGTACGTGTGGTCCAGGTCCT|CTAAGATAGAGGGACCGCAGGGACGGTAGG
GCGCAGGGTGATCCGTGGGGTCGTACCCTA|GGGACCGCAGGCGTGGGTACTACGGAGCAA
GGACTTTAAGCCTACCAACGTGCAGCGCGG|GGACGTCCAGGTCCTAAGATAGAGGGACCG
CCATGGTCAATGGACTAGGGGTATGGGGAC|GCGGCTTCTGGCACTATATCCTAGCTCATC
GCAGGATGATTAGCACGCACCCCAGGCTTG|CCACGTACTGCAGATTCTTCATTGTATGAT
GCGCGGGGCTTATAGGTCCTACAGAAAATG|GTCCAGGTCCTAAGATAGAGGGACCGCAGG
TCCTAAGATAGAGGGACCGCAGGATGATTA|GGCCAGGCTCGCTTCCGTCCACGTACTGCA
ATAAAGATGAGACTACGCATAGACGCATAC|GTCCTAAGATAGAGGGACCGCAGGCGGCAC
ATAGAGGGACCGCAGGAAGATAGAGGGACC|TCCCTGCCTTTCCCACGCTCAGGGACTTTA
ATTTCAGAGGGCCGTATTTAAAGTCCAGGT|GGTCCTAAGATAGAGGGACCGCAGGTTAAA
GGCCTCAGGCGCGGGGCTTATAGGTCCTAC|TTGTACTAGTCCAGGTCCTAAGATAGAGGG
TATTTCTTTAATTCTGATGCTTCATTTCAG|CTAAACCACAGAACTAAAGTCCAGGTCCTA
CTGGTACACCACCGTCCAGGTCCTAAGATA|TAGCACAAGTGCGATAAAGATGAGACTACG
ACGCACAACGATACAAATTCCCTGCCTTTC|TAAGATAGTCCAGGTCCTAAGATAGAGGGA
GGTCCAGGTCCTAAGATAGAGGGACCGCAG|AGGGACGGTAGGCGTCCCCGGTCCAGGTCC
CACAAGTGCGATAAAGATGAGACTACGCAT|ACCAGTCCAGGTCCTAAGATAGAGGGACCG
GATGCTTCATTTCAGAGGGCCGTATTTAAA|AAAGTCCAGGTCCTAAGATAGAGGGACCGC
CGCAGGGACGGTAGGCGTCCCCGGTCCAGG|CACCGTCCAGGTCCTAAGATAGAGGGACCG
TCCTAAGATAGAGGGACCGCAGGCCTTTCT|CAGGCGTAGTCGAGCATGTTCCCCCAACGG
AGCGACGCACTCCCCCTAGGTTGCTAGCAC|GCTTAAGAGCCGTCTGTTGGTGATACTACC
ATAGAGGGACCGCAGGGAGGGACGTCCAGG|GCGCCAAGTACATATGCTGCTTACCAATCG
TCGTCGCATATCTCTACTCAACAAGCGAGA|TGTTTCCGCAAATAAATCGGCAGGAGAAAC
TAGAGGGACCGCAGGGTCTCCTTTTCATCC|AGGGACTTTAAGCCTACCAACGTGCAGCGC
GGGTCGTATTTCTTTAATTCTGATGCTTCA|TTTCTACTAAACCACAGAACTAAAGTCCAG
AGGTCCTAAGATAGTCCAGGTCCTAAGATA|GCCTGCGCGGACGCGTGTAAGGACACTGCG
AGATAGAGGGACCGCAGGCGCAGGGTGATC|CCAGGTCCTAAGATAGAGGGACCGCAGGCG
CGGACGTCCAGGTCCTAAGATAGAGGGACC|AGGCGCGGGGCTTATAGGTCCTACAGAAAA
ACGCTCGAAGCTGATTCATTGACACTCTGA|GGTGGTGTTCCTAATCAAAGGATTAGAGCG
GTCAATGGACTAGGGGTATGGGGACTAGTC|TTCTGGCACTATATCCTAGCTCATCAGCAA
CGCAGGCCCCTGTGTTCCCGTACGTGTGGT|GTCCAGGTCCTAAGATAGAGGGACCGCAGG
GGGACCGCAGGGTCTCCTTTTCATCCATGG|ACTTTAAGCCTACCAACGTGCAGCGCGGCT
CACTAAGTCCAGGTCCTGTCCAGGTCCTAA|GGGACCGCAGGAGACGCACAACGATACAAA
AGACTACGCATAGACGCATACCGCCGCATA|TAGAGGGACCGCAGGCGGCACGGTCGCAGG
AAGCCTACCAACGTGCAGCGCGGCTTCTGG|CAGGTCCTAAGATAGAGGGACCGCAGGCGC
GCATGTTCCCCCAACGGTACACGCTCGAAG|TGGCCACGCCCCAAGGATTCGGTGGTGTTC
CCGCAGGCCTTTCTACTAAACCACAGAACT|TGTTCCCCCAACGGTACACGCTCGAAGCTG
TGATTAGCACGCACCCCAGGCTTGTTTCCG|ACTGCAGATTCTTCATTGTATGATCATCCG
ATAGAGGGACCGCAGGGTCTCCTTTTCATC|CAGGGACTTTAAGCCTACCAACGTGCAGCG
CTAAGATAGAGGGACCGCAGGATGATTAGC|CCAGGCTCGCTTCCGTCCACGTACTGCAGA
AGGCCCCTGTGTTCCCGTACGTGTGGTCCA|CAGGTCCTAAGATAGAGGGACCGCAGGGAC
GTCCAGGTCCTAAGATAGAGGGACCGCAGG|CGGGGCTTATAGGTCCTACAGAAAATGGTC
CCGCAGGGACGGTAGGCGTCCCCGGTCCAG|CCACCGTCCAGGTCCTAAGATAGAGGGACC
AAAGTCGGAGTCCAGGTCCTAAGATAGTCC|CAATATATTCTGGGCCTGCGCGGACGCGTG
GGGACCGCAGGCGTAGTCGAGCATGTTCCC|TAGACGCATACCGCCGCATATGGCCACGCC
GACTAGGGGTATGGGGACTAGTCCAGGTCC|ACTATATCCTAGCTCATCAGCAAGATTCGT
CACGCTCGAAGCTGATTCATTGACACTCTG|CGGTGGTGTTCCTAATCAAAGGATTAGAGC
TATGTTAATACTCTACATTCGTCGCATATC|TAGCACGCACCCCAGGCTTGTTTCCGCAAA
CCCGGTCCAGGTCCTAAGATAGAGGGACCG|TAGAGGGACCGCAGGCGTAGTCGAGCATGT
GCAGGGTGATCCGTGGGGTCGTACCCTATT|GACCGCAGGCGTGGGTACTACGGAGCAAGC
CCTAAGATAGAGGGACCGCAGGCCCTGTTG|AGGCGTCCCCGGTCCAGGTCCTAAGATAGA
CCCGACCACTAAGTCCAGGTCCTGTCCAGG|GATAGAGGGACCGCAGGAGACGCACAACGA
ACAGATCTCCCCCGCAGGCCCCTGTGTTCC|GCCGTATTTAAAGTCCAGGTCCTAAGATAG
GATACTACCAGTCCAGGTCCTAAGATAGAG|AGAGGGACCGCAGGGTCTCCTTTTCATCCA
TTCATTGACACTCTGAAAAGAGCGACGCAC|TCAAAGGATTAGAGCGATAGGCTTAAGAGC
CTTCATTTCAGAGGGCCGTATTTAAAGTCC|TCCAGGTCCTAAGATAGAGGGACCGCAGGT
ATAGAGGGACCGCAGGCGCAGGGTGATCCG|AGGTCCTAAGATAGAGGGACCGCAGGCGTG
GTCTGGTACACCACCGTCCAGGTCCTAAGA|GCTAGCACAAGTGCGATAAAGATGAGACTA
ACCGCAGGAAGATAGAGGGACCGCAGGGTC|TTTCCCACGCTCAGGGACTTTAAGCCTACC
GGGACCGCAGGCGTGGGTACTACGGAGCAA|AGAAAATGGTCCAGGTCCTAAGATAGAGGG
ACATTCGTCGCATATCTCTACTCAACAAGC|GGCTTGTTTCCGCAAATAAATCGGCAGGAG
TTCGGTGGTGTTCCTAATCAAAGGATTAGA|CCCGACCACTAAGTCCAGGTCCTGTCCAGG
GATCCGTGGGGTCGTACCCTATTGCCAGTC|GGCGTGGGTACTACGGAGCAAGCCGTAAGC
CTACTCAACAAGCGAGAGCCCTCCTGGGCC|AAATCGGCAGGAGAAACGGATAGCGATTGT
ATGGCCACGCCCCAAGGATTCGGTGGTGTT|GTATCCTTACTACGCGTACCCGACCACTAA
CTATGTTAATACTCTACATTCGTCGCATAT|TTAGCACGCACCCCAGGCTTGTTTCCGCAA
ATGGTCCAGGTCCTAAGATAGAGGGACCGC|AGGCTATGTGGGCCAGGCTCGCTTCCGTCC
CATATGCTGCTTACCAATCGGACGTCCAGG|AGAGCCCTCCTGGGCCTCAGGCGCGGGGCT
TTTAAAGTCCAGGTCCTAAGATAGAGGGAC|GACCGCAGGTTAAACAAGGGTCTGGTACAC
TGTTGGTGATACTACCAGTCCAGGTCCTAA|GGAAGATAGAGGGACCGCAGGGTCTCCTTT
CGTGGGTACTACGGAGCAAGCCGTAAGCCT|CAGGTCCTAAGATAGAGGGACCGCAGGATG
AGGATGATTAGCACGCACCCCAGGCTTGTT|ACGTACTGCAGATTCTTCATTGTATGATCA
AAGATAGAGGGACCGCAGGCGTGGGTACTA|GGTCCTACAGAAAATGGTCCAGGTCCTAAG
CTAGGGGTATGGGGACTAGTCCAGGTCCTA|TATATCCTAGCTCATCAGCAAGATTCGTGA
TGCTAGCACAAGTGCGATAAAGATGAGACT|GATACTACCAGTCCAGGTCCTAAGATAGAG
CTAAGATAGAGGGACCGCAGGCGTGGGTAC|TAGGTCCTACAGAAAATGGTCCAGGTCCTA
GGAGTCCAGGTCCTAAGATAGTCCAGGTCC|ATTCTGGGCCTGCGCGGACGCGTGTAAGGA
CATCAGCAAGATTCGTGACAAAGTCGGAGT|GTCGTACCCTATTGCCAGTCAATATATTCT
TCGGACGTCCAGGTCCTAAGATAGAGGGAC|CAGGCGCGGGGCTTATAGGTCCTACAGAAA
CTGTTGTGTTCAGAATTCTGGGTCGTATTT|GATAGAGGGACCGCAGGCCTTTCTACTAAA
TCTGGTACACCACCGTCCAGGTCCTAAGAT|CTAGCACAAGTGCGATAAAGATGAGACTAC
CCGCATATGGCCACGCCCCAAGGATTCGGT|TCGCAGGTATCCTTACTACGCGTACCCGAC
GTACACCACCGTCCAGGTCCTAAGATAGAG|CACAAGTGCGATAAAGATGAGACTACGCAT
TGGTGTTCCTAATCAAAGGATTAGAGCGAT|CCACTAAGTCCAGGTCCTGTCCAGGTCCTA
TTGTGTTCAGAATTCTGGGTCGTATTTCTT|AGAGGGACCGCAGGCCTTTCTACTAAACCA
TGCCTTTCCCACGCTCAGGGACTTTAAGCC|TAGAGGGACCGCAGGGAGGGACGTCCAGGT
CTTTAAGCCTACCAACGTGCAGCGCGGCTT|CGTCCAGGTCCTAAGATAGAGGGACCGCAG
TACGTGTGGTCCAGGTCCTAAGATAGAGGG|GGACCGCAGGGACGGTAGGCGTCCCCGGTC
CACAGAACTAAAGTCCAGGTCCTAAGATAG|TCGAAGCTGATTCATTGACACTCTGAAAAG
AATGGACTAGGGGTATGGGGACTAGTCCAG|TGGCACTATATCCTAGCTCATCAGCAAGAT
CGCACCCCAGGCTTGTTTCCGCAAATAAAT|TCTTCATTGTATGATCATCCGGGCGGTCGA
GCGGACGCGTGTAAGGACACTGCGCCAAGT|ACATTCGTCGCATATCTCTACTCAACAAGC
CTCCTGGGCCTCAGGCGCGGGGCTTATAGG|TAGCGATTGTACTAGTCCAGGTCCTAAGAT
TGACACTCTGAAAAGAGCGACGCACTCCCC|GGATTAGAGCGATAGGCTTAAGAGCCGTCT
AGGTCCTGTCCAGGTCCTAAGATAGAGGGA|GAGACGCACAACGATACAAATTCCCTGCCT
GCGTGGGTACTACGGAGCAAGCCGTAAGCC|CCAGGTCCTAAGATAGAGGGACCGCAGGAT
CTTTAATTCTGATGCTTCATTTCAGAGGGC|CCACAGAACTAAAGTCCAGGTCCTAAGATA
GTGGTCCAGGTCCTAAGATAGAGGGACCGC|GCAGGGACGGTAGGCGTCCCCGGTCCAGGT
TACCCTATTGCCAGTCAATATATTCTGGGC|GGAGCAAGCCGTAAGCCTACTATGTTAATA
ACAAAGTCGGAGTCCAGGTCCTAAGATAGT|GTCAATATATTCTGGGCCTGCGCGGACGCG
TATTTAAAGTCCAGGTCCTAAGATAGAGGG|GGGACCGCAGGTTAAACAAGGGTCTGGTAC
CGTAGTCGAGCATGTTCCCCCAACGGTACA|CGCCGCATATGGCCACGCCCCAAGGATTCG
CTAAGATAGAGGGACCGCAGGAGACGCACA|TGACAAAGTCGGAGTCCAGGTCCTAAGATA
GGACCGCAGGAAGATAGAGGGACCGCAGGG|CCTTTCCCACGCTCAGGGACTTTAAGCCTA
CAACGATACAAATTCCCTGCCTTTCCCACG|TAGTCCAGGTCCTAAGATAGAGGGACCGCA
GAGACTACGCATAGACGCATACCGCCGCAT|ATAGAGGGACCGCAGGCGGCACGGTCGCAG
CAACGTGCAGCGCGGCTTCTGGCACTATAT|AAGATAGAGGGACCGCAGGCGCAGGGTGAT
GAAAAGAGCGACGCACTCCCCCTAGGTTGC|CGATAGGCTTAAGAGCCGTCTGTTGGTGAT
TCCCACGCTCAGGGACTTTAAGCCTACCAA|GACCGCAGGGAGGGACGTCCAGGTCCTAAG
CAGGTTAAACAAGGGTCTGGTACACCACCG|ACTCCCCCTAGGTTGCTAGCACAAGTGCGA
TTTCTTTAATTCTGATGCTTCATTTCAGAG|AAACCACAGAACTAAAGTCCAGGTCCTAAG
GGGTCGTACCCTATTGCCAGTCAATATATT|TACTACGGAGCAAGCCGTAAGCCTACTATG
CAGGTCCTAAGATAGAGGGACCGCAGGAAG|ACGATACAAATTCCCTGCCTTTCCCACGCT
ACCGCAGGGACGGTAGGCGTCCCCGGTCCA|ACCACCGTCCAGGTCCTAAGATAGAGGGAC
CTTACCAATCGGACGTCCAGGTCCTAAGAT|CTGGGCCTCAGGCGCGGGGCTTATAGGTCC
TGTCCAGGTCCTAAGATAGAGGGACCGCAG|CACAACGATACAAATTCCCTGCCTTTCCCA
TAAGATAGAGGGACCGCAGGCGCAGGGTGA|GTCCAGGTCCTAAGATAGAGGGACCGCAGG
AGGCGTGGGTACTACGGAGCAAGCCGTAAG|GTCCAGGTCCTAAGATAGAGGGACCGCAGG
GGTCCTAAGATAGAGGGACCGCAGGTTAAA|ACACTCTGAAAAGAGCGACGCACTCCCCCT
CTCTGAAAAGAGCGACGCACTCCCCCTAGG|AGAGCGATAGGCTTAAGAGCCGTCTGTTGG
AGTCCAGGTCCTGTCCAGGTCCTAAGATAG|CGCAGGAGACGCACAACGATACAAATTCCC
AGTCCAGGTCCTAAGATAGAGGGACCGCAG|CAGGTTAAACAAGGGTCTGGTACACCACCG
TAAGATAGAGGGACCGCAGGATGATTAGCA|CAGGCTCGCTTCCGTCCACGTACTGCAGAT
GGGACGGTAGGCGTCCCCGGTCCAGGTCCT|GTCCAGGTCCTAAGATAGAGGGACCGCAGG
ATGGGGACTAGTCCAGGTCCTAAGATAGAG|AGCTCATCAGCAAGATTCGTGACAAAGTCG
GTCGGAGTCCAGGTCCTAAGATAGTCCAGG|TATATTCTGGGCCTGCGCGGACGCGTGTAA
AAAGGATTAGAGCGATAGGCTTAAGAGCCG|TCCTGTCCAGGTCCTAAGATAGAGGGACCG
GACCGCAGGGACGGTAGGCGTCCCCGGTCC|CACCACCGTCCAGGTCCTAAGATAGAGGGA
AAGATAGAGGGACCGCAGGTTAAACAAGGG|TGAAAAGAGCGACGCACTCCCCCTAGGTTG
CTAAGATAGAGGGACCGCAGGCCTTTCTAC|GGCGTAGTCGAGCATGTTCCCCCAACGGTA
AAGATAGTCCAGGTCCTAAGATAGAGGGAC|CGGACGCGTGTAAGGACACTGCGCCAAGTA
CCAGGTCCTAAGATAGAGGGACCGCAGGAA|AACGATACAAATTCCCTGCCTTTCCCACGC
AGGTCCTAAGATAGAGGGACCGCAGGAAGA|CGATACAAATTCCCTGCCTTTCCCACGCTC
GCCTACCAACGTGCAGCGCGGCTTCTGGCA|GGTCCTAAGATAGAGGGACCGCAGGCGCAG
CCTAAGATAGAGGGACCGCAGGGACGGTAG|CAAGGGTCTGGTACACCACCGTCCAGGTCC
TCGCAGGTATCCTTACTACGCGTACCCGAC|TATGGGGACTAGTCCAGGTCCTAAGATAGA
GACGTCCAGGTCCTAAGATAGAGGGACCGC|TTACCAATCGGACGTCCAGGTCCTAAGATA
CGCAGGGTCTCCTTTTCATCCATGGTCAAT|AAGCCTACCAACGTGCAGCGCGGCTTCTGG
ACTACGGAGCAAGCCGTAAGCCTACTATGT|TAAGATAGAGGGACCGCAGGATGATTAGCA
AGTCCAGGTCCTAAGATAGAGGGACCGCAG|GCAAGATTCGTGACAAAGTCGGAGTCCAGG
GAAGCTGATTCATTGACACTCTGAAAAGAG|GTTCCTAATCAAAGGATTAGAGCGATAGGC
GTCGTATTTCTTTAATTCTGATGCTTCATT|TCTACTAAACCACAGAACTAAAGTCCAGGT
AGATAGAGGGACCGCAGGCGTAGTCGAGCA|CTACGCATAGACGCATACCGCCGCATATGG
CTCCTTTTCATCCATGGTCAATGGACTAGG|CAACGTGCAGCGCGGCTTCTGGCACTATAT
CCTAAGATAGAGGGACCGCAGGCGTGGGTA|ATAGGTCCTACAGAAAATGGTCCAGGTCCT
AGGGCCGTATTTAAAGTCCAGGTCCTAAGA|AGATAGAGGGACCGCAGGTTAAACAAGGGT
GCGAAGTGAACAGATCTCCCCCGCAGGCCC|TTTCAGAGGGCCGTATTTAAAGTCCAGGTC
GGCGGCACGGTCGCAGGTATCCTTACTACG|GGACTAGGGGTATGGGGACTAGTCCAGGTC
TATCCTTACTACGCGTACCCGACCACTAAG|ACTAGTCCAGGTCCTAAGATAGAGGGACCG
TGTGGTCCAGGTCCTAAGATAGAGGGACCG|CGCAGGGACGGTAGGCGTCCCCGGTCCAGG
AGGGACCGCAGGTTAAACAAGGGTCTGGTA|AGCGACGCACTCCCCCTAGGTTGCTAGCAC
TATCTCTACTCAACAAGCGAGAGCCCTCCT|CAAATAAATCGGCAGGAGAAACGGATAGCG
CAGGAAGATAGAGGGACCGCAGGGTCTCCT|CCACGCTCAGGGACTTTAAGCCTACCAACG
GGTGGTGTTCCTAATCAAAGGATTAGAGCG|GACCACTAAGTCCAGGTCCTGTCCAGGTCC
GGGACTAGTCCAGGTCCTAAGATAGAGGGA|TCATCAGCAAGATTCGTGACAAAGTCGGAG
GCAGGCCCTGTTGTGTTCAGAATTCTGGGT|GTCCTAAGATAGAGGGACCGCAGGCCTTTC
GCGTACCCGACCACTAAGTCCAGGTCCTGT|CCTAAGATAGAGGGACCGCAGGAGACGCAC
GGCTTATAGGTCCTACAGAAAATGGTCCAG|GTCCTAAGATAGAGGGACCGCAGGCTATGT
TCGTGACAAAGTCGGAGTCCAGGTCCTAAG|TGCCAGTCAATATATTCTGGGCCTGCGCGG
TACGCGTACCCGACCACTAAGTCCAGGTCC|GGTCCTAAGATAGAGGGACCGCAGGAGACG
AGCCTACCAACGTGCAGCGCGGCTTCTGGC|AGGTCCTAAGATAGAGGGACCGCAGGCGCA
GCAGGGTCTCCTTTTCATCCATGGTCAATG|AGCCTACCAACGTGCAGCGCGGCTTCTGGC
GGCTTCTGGCACTATATCCTAGCTCATCAG|CGCAGGCGCAGGGTGATCCGTGGGGTCGTA
TTAAACAAGGGTCTGGTACACCACCGTCCA|CCCCTAGGTTGCTAGCACAAGTGCGATAAA
AACGTGCAGCGCGGCTTCTGGCACTATATC|AGATAGAGGGACCGCAGGCGCAGGGTGATC
GCTTATAGGTCCTACAGAAAATGGTCCAGG|TCCTAAGATAGAGGGACCGCAGGCTATGTG
GGGTACTACGGAGCAAGCCGTAAGCCTACT|GTCCTAAGATAGAGGGACCGCAGGATGATT
AGGCGTCCCCGGTCCAGGTCCTAAGATAGA|CCTAAGATAGAGGGACCGCAGGCGTAGTCG
CCCTGTTGTGTTCAGAATTCTGGGTCGTAT|AAGATAGAGGGACCGCAGGCCTTTCTACTA
ATAGGCTTAAGAGCCGTCTGTTGGTGATAC|TAAGATAGAGGGACCGCAGGAAGATAGAGG
ACTCTACATTCGTCGCATATCTCTACTCAA|CCCCAGGCTTGTTTCCGCAAATAAATCGGC
TTCTGATGCTTCATTTCAGAGGGCCGTATT|AACTAAAGTCCAGGTCCTAAGATAGAGGGA
GCTAGCACAAGTGCGATAAAGATGAGACTA|ATACTACCAGTCCAGGTCCTAAGATAGAGG
CAAGTGCGATAAAGATGAGACTACGCATAG|CAGTCCAGGTCCTAAGATAGAGGGACCGCA
CAACAAGCGAGAGCCCTCCTGGGCCTCAGG|GGCAGGAGAAACGGATAGCGATTGTACTAG
CAGGTCCTAAGATAGAGGGACCGCAGGTTA|TGACACTCTGAAAAGAGCGACGCACTCCCC
GGCACGGTCGCAGGTATCCTTACTACGCGT|CTAGGGGTATGGGGACTAGTCCAGGTCCTA
GATTCATTGACACTCTGAAAAGAGCGACGC|AATCAAAGGATTAGAGCGATAGGCTTAAGA
GACCGCAGGCGCAGGGTGATCCGTGGGGTC|AAGATAGAGGGACCGCAGGCGTGGGTACTA
CTAAGATAGAGGGACCGCAGGCGCAGGGTG|CGTCCAGGTCCTAAGATAGAGGGACCGCAG
CGCCCCAAGGATTCGGTGGTGTTCCTAATC|TACTACGCGTACCCGACCACTAAGTCCAGG
AGGGTCTGGTACACCACCGTCCAGGTCCTA|GTTGCTAGCACAAGTGCGATAAAGATGAGA
CGCGGCTTCTGGCACTATATCCTAGCTCAT|GACCGCAGGCGCAGGGTGATCCGTGGGGTC
GGTATCCTTACTACGCGTACCCGACCACTA|GGACTAGTCCAGGTCCTAAGATAGAGGGAC
CTTATAGGTCCTACAGAAAATGGTCCAGGT|CCTAAGATAGAGGGACCGCAGGCTATGTGG
GCACTCCCCCTAGGTTGCTAGCACAAGTGC|GAGCCGTCTGTTGGTGATACTACCAGTCCA
CATTCGTCGCATATCTCTACTCAACAAGCG|GCTTGTTTCCGCAAATAAATCGGCAGGAGA
CAGGTCCTGTCCAGGTCCTAAGATAGAGGG|GGAGACGCACAACGATACAAATTCCCTGCC
TGCTTCATTTCAGAGGGCCGTATTTAAAGT|AGTCCAGGTCCTAAGATAGAGGGACCGCAG
TACATATGCTGCTTACCAATCGGACGTCCA|CGAGAGCCCTCCTGGGCCTCAGGCGCGGGG
ACCGCAGGGAGGGACGTCCAGGTCCTAAGA|TACATATGCTGCTTACCAATCGGACGTCCA
TACATTCGTCGCATATCTCTACTCAACAAG|AGGCTTGTTTCCGCAAATAAATCGGCAGGA
GTGTTCCTAATCAAAGGATTAGAGCGATAG|ACTAAGTCCAGGTCCTGTCCAGGTCCTAAG
TATTGCCAGTCAATATATTCTGGGCCTGCG|AAGCCGTAAGCCTACTATGTTAATACTCTA
TAAAGATGAGACTACGCATAGACGCATACC|TCCTAAGATAGAGGGACCGCAGGCGGCACG
CGCAGGGTGATCCGTGGGGTCGTACCCTAT|GGACCGCAGGCGTGGGTACTACGGAGCAAG
GATCTCCCCCGCAGGCCCCTGTGTTCCCGT|GTATTTAAAGTCCAGGTCCTAAGATAGAGG
GCACAACGATACAAATTCCCTGCCTTTCCC|AGATAGTCCAGGTCCTAAGATAGAGGGACC
